상권코드명,총직장인구수,남성직장인구수,여성직장인구수,연령대10직장인구수,연령대20직장인구수,연령대30직장인구수,연령대40직장인구수,연령대50직장인구수,연령대60이상직장인구수
가락로16길,844,488,356,2,62,117,143,189,331
가락로28길,156,69,87,0,16,32,52,43,13
가락로36길,347,203,144,5,45,68,80,88,61
가로공원로76길,222,111,111,9,31,49,54,47,32
가마산로61길,39,30,9,0,4,9,6,14,6
가마산로88길,236,131,105,2,25,47,52,60,50
가마산로89길,148,77,71,0,7,11,22,39,69
가산로3길,2402,1900,502,14,319,553,651,611,254
가산로5길,539,389,150,7,71,137,164,109,51
가재울로14길,56,35,21,0,5,11,18,17,5
가재울로4길,54,37,17,0,6,9,20,9,10
가재울로6길,66,28,38,0,8,11,20,12,15
가좌로6길,136,76,60,1,6,18,36,52,23
가좌로7길,184,109,75,0,19,54,46,41,24
가좌로7다길,49,24,25,0,3,17,16,11,2
가좌로9길,106,42,64,1,16,15,38,20,16
갈현로1길,77,22,55,0,8,13,14,21,21
갈현로23길,63,17,46,0,6,8,14,12,23
갈현로29길,94,37,57,0,5,16,34,19,20
갈현로33길,82,30,52,0,18,15,32,16,1
갈현로3길,83,38,45,2,18,17,21,20,5
갈현로41길,102,33,69,0,11,19,26,33,13
갈현로4길,176,78,98,0,28,37,55,33,23
강남대로107길,713,501,212,23,181,252,158,67,32
강남대로83길,39,26,13,1,4,11,13,5,5
강남대로89길,121,87,34,0,9,18,16,20,58
강남대로8길,3466,1957,1509,4,416,791,932,760,563
강동대로9길,222,90,132,4,33,56,54,41,34
강서로17다길,232,94,138,0,33,49,57,65,28
강서로18길,117,37,80,0,11,21,43,29,13
강서로18다길,44,11,33,0,1,7,22,13,1
강서로39길,128,50,78,1,16,16,32,34,29
강서로45길,256,107,149,1,33,47,75,66,34
강서로47가길,631,150,481,1,144,211,152,100,23
강서로47길,211,86,125,0,27,50,72,43,19
강서로48길,112,59,53,0,12,25,24,37,14
강서로74길,3220,1402,1818,33,329,491,696,1250,421
강서로8길,138,58,80,0,17,38,39,28,16
개봉로2길,3289,1827,1462,1,62,75,146,410,2595
개봉로3길,281,121,160,0,41,41,104,64,31
개포로109길,11545,9262,2283,115,3872,3699,1965,1366,528
개포로82길,103,48,55,2,11,16,26,36,12
거북골로16길,39,23,16,0,2,9,15,7,6
거북골로20길,188,99,89,2,13,32,59,57,25
경기대로9길,598,306,292,2,108,163,142,113,70
경인로22길,21,12,9,0,0,9,2,4,6
경인로35길,225,55,170,0,22,47,71,69,16
경인로40길,305,225,80,0,40,38,65,75,87
경인로47길,625,248,377,1,163,161,162,103,35
경인로47다길,98,62,36,0,7,22,27,22,20
경인로59길,154,49,105,0,27,43,43,26,15
경희대로1길,24,11,13,3,6,2,3,8,2
경희대로3길,45,17,28,0,10,6,6,20,3
경희대로4길,25,11,14,0,0,11,8,4,2
경희대로6길,76,25,51,1,20,17,17,14,7
고덕로10길,48,11,37,0,10,12,16,6,4
고산자로14길,139,68,71,2,12,27,42,31,25
고산자로16길,94,46,48,2,9,22,33,19,9
고산자로2길,84,30,54,0,12,10,28,17,17
고산자로31길,15,8,7,0,0,3,3,4,5
고산자로6길,319,148,171,1,47,60,68,69,74
고산자로8나길,866,454,412,5,136,190,224,207,104
고척로21나길,447,131,316,0,68,84,109,137,49
고척로27길,90,39,51,0,11,14,29,28,8
고척로33길,75,17,58,0,11,6,27,25,6
고척로52길,67,41,26,0,2,11,18,20,16
곰달래로31가길,231,59,172,0,25,61,68,63,14
곰달래로31길,347,184,163,0,39,70,85,81,72
곰달래로35길,31,5,26,0,10,7,6,6,2
곰달래로60길,176,118,58,1,21,31,41,35,47
공릉로12가길,66,43,23,0,8,21,14,20,3
공릉로12길,47,31,16,1,8,14,7,13,4
공릉로2길,152,73,79,0,13,38,44,33,24
공릉로34길,480,276,204,1,69,110,103,102,95
공릉로58가길,59,39,20,0,2,11,17,20,9
공릉로59나길,124,53,71,0,19,22,41,29,13
공릉로65길,35,5,30,0,13,7,11,3,1
공항대로41길,870,410,460,2,132,191,206,194,145
공항대로42길,111,66,45,0,27,24,24,17,19
공항대로45길,5349,1480,3869,12,296,767,2005,2084,185
공항대로55길,313,193,120,2,71,119,69,36,16
공항대로61길,1079,663,416,9,210,343,281,158,78
공항대로7길,310,238,72,0,21,32,58,97,102
관악로11길,39,17,22,0,6,7,15,4,7
관악로14길,155,92,63,0,10,34,40,39,32
관악로24길,74,22,52,0,7,19,25,12,11
관악로28길,36,13,23,0,6,13,9,3,5
관천로11길,460,217,243,0,59,83,128,140,50
광나루로11길,137,66,71,0,8,13,27,39,50
광나루로12길,28,18,10,0,0,7,8,10,3
광나루로56길,141,51,90,0,8,19,27,19,68
광성로4길,58,34,24,0,11,9,16,13,9
광운로2길,9,7,2,0,0,1,4,2,2
광운로3길,41,33,8,2,5,12,11,8,3
광평로19길,270,156,114,0,34,69,69,52,46
구로동로28길,99,36,63,2,21,23,27,20,6
구로동로29길,276,98,178,3,68,84,58,43,20
구로동로35길,124,69,55,0,17,23,31,37,16
구로동로42길,90,44,46,0,10,16,29,19,16
구로중앙로19길,638,380,258,4,140,236,164,64,30
구로중앙로28길,824,554,270,0,59,99,168,305,193
구로중앙로7길,52,17,35,0,2,10,17,15,8
구로중앙로8길,243,103,140,1,17,55,79,54,37
구일로10길,218,135,83,0,30,53,68,42,25
국제금융로7길,73,32,41,6,3,16,20,13,15
국회단지길,86,53,33,0,13,26,20,14,13
금낭화로23길,41,13,28,0,5,7,12,11,6
금하로24길,103,28,75,0,26,16,27,27,7
금호로1길,33,14,19,2,3,6,11,7,4
금호산2길,74,29,45,0,15,15,16,18,10
길음로13길,11,4,7,0,0,1,7,1,2
길음로7길,113,39,74,0,20,23,36,24,10
까치산로10길,40,17,23,1,3,4,13,9,10
낙성대역10길,22,11,11,0,2,1,9,9,1
낙성대역3길,50,15,35,0,5,7,9,16,13
난계로29길,1218,718,500,9,144,289,327,252,197
난계로30길,4862,2191,2671,6,427,1393,2057,933,46
난곡로26길,44,14,30,0,1,7,22,12,2
난곡로30길,211,122,89,0,16,42,64,75,14
난곡로34길,94,22,72,0,20,22,22,16,14
난곡로35길,68,34,34,0,8,9,30,19,2
난곡로63길,264,143,121,2,31,50,60,65,56
난곡로66길,90,32,58,0,14,16,19,21,20
난곡로78길,88,44,44,0,10,23,19,26,10
난우길,384,165,219,1,69,79,91,80,64
난향2길,6,0,6,0,1,1,1,2,1
난향길,40,11,29,0,6,7,11,11,5
남부순환로124길,496,225,271,0,50,150,125,104,67
남부순환로144길,339,152,187,3,72,56,60,74,74
남부순환로145길,216,106,110,2,31,41,63,61,18
남부순환로151길,205,92,113,0,25,39,47,58,36
남부순환로153길,120,44,76,0,23,27,29,27,14
남부순환로159길,118,61,57,0,6,11,39,46,16
남부순환로170길,300,131,169,1,23,32,67,86,91
남부순환로191길,296,141,155,0,37,59,100,72,28
남부순환로208길,148,61,87,1,27,30,42,23,25
남부순환로230길,145,68,77,0,17,35,37,32,24
남부순환로234길,129,40,89,0,16,26,35,30,22
남부순환로248길,273,101,172,1,44,40,73,74,41
남부순환로272길,131,61,70,0,20,36,41,24,10
남부순환로317길,2002,1269,733,43,457,588,493,273,148
남부순환로323길,523,287,236,3,101,162,122,73,62
남부순환로333길,13727,6311,7416,138,4302,3472,2855,2290,670
남부순환로337가길,562,398,164,1,117,217,137,48,42
남부순환로350길,2393,816,1577,7,392,590,684,537,183
남부순환로356길,1137,710,427,3,223,352,246,191,122
남부순환로40길,86,35,51,1,14,17,25,26,3
남부순환로59길,86,47,39,0,5,12,34,26,9
남부순환로70길,268,139,129,0,21,44,68,76,59
남부순환로95길,83,44,39,0,5,4,16,21,37
남부순환로97길,88,33,55,1,24,32,18,6,7
남현2길,637,319,318,3,80,136,182,188,48
남현3길,490,383,107,5,39,92,167,100,87
남현4길,95,65,30,0,10,23,23,21,18
남현길,191,87,104,1,34,50,51,37,18
노량진로6길,145,81,64,0,19,31,30,32,33
노량진로8길,2391,1118,1273,5,290,811,651,530,104
노원로1길,230,63,167,0,36,49,67,61,17
노해로17길,60,25,35,0,3,11,12,16,18
노해로35길,7,6,1,0,0,2,1,3,1
노해로41길,166,75,91,0,30,27,37,42,30
노해로65길,188,73,115,2,32,45,48,47,14
노해로70길,72,33,39,0,4,11,21,26,10
노해로8가길,72,40,32,0,11,18,22,15,6
녹사평대로26길,167,88,79,1,24,59,34,34,15
녹사평대로40길,274,160,114,7,93,80,42,25,27
녹사평대로46가길,122,73,49,6,56,33,11,8,8
녹사평대로46길,199,105,94,1,25,61,74,36,2
논현로5길,767,363,404,3,92,120,169,233,150
논현로8길,2146,1407,739,7,347,482,447,440,423
능동로19길,96,66,30,0,13,16,19,30,18
능동로4길,377,105,272,0,33,64,157,89,34
다동길,4919,2696,2223,9,353,1603,2094,777,83
다산로14길,171,84,87,0,40,50,39,25,17
다산로36길,868,566,302,5,106,236,232,226,63
다산로42나길,162,75,87,0,43,38,30,39,12
다산로44길,265,98,167,1,33,66,48,71,46
다산로8길,287,103,184,0,46,93,67,42,39
답십리로30길,34,23,11,0,5,8,12,6,3
답십리로56길,38,13,25,1,5,16,3,9,4
답십리로65길,353,178,175,0,68,83,68,89,45
답십리로66길,657,283,374,5,111,172,136,157,76
답십리로68길,656,269,387,4,99,141,150,173,89
답십리로72길,125,73,52,0,14,27,27,26,31
당곡길,134,59,75,1,23,24,47,27,12
당산로10길,625,413,212,5,59,192,160,133,76
당산로16길,1088,545,543,5,116,169,239,241,318
당산로18길,541,206,335,1,36,61,116,144,183
당산로28길,65,52,13,0,7,13,17,16,12
당산로31길,695,424,271,1,92,190,190,157,65
당산로37길,10199,4872,5327,140,3028,2825,2250,1231,725
당산로38길,994,516,478,2,67,139,173,331,282
당산로44길,173,68,105,1,35,33,51,32,21
당산로48길,1103,660,443,8,86,249,318,313,129
당산로52길,1111,679,432,8,89,255,313,319,127
대림로22길,40,23,17,0,3,2,18,9,8
대림로29길,361,232,129,1,41,63,117,93,46
대림로34길,148,106,42,1,11,37,47,29,23
대림로44길,374,178,196,0,37,77,81,112,67
대사관로30가길,45,21,24,0,2,7,19,11,6
대사관로31길,1683,510,1173,6,596,459,398,175,49
대사관로34길,713,450,263,5,98,121,143,174,172
대학5길,57,25,32,0,22,11,13,6,5
대학길,70,25,45,0,9,18,16,21,6
대흥로21길,173,68,105,0,27,38,39,23,46
덕릉로24길,297,257,40,0,17,46,64,85,85
덕릉로28길,395,159,236,2,58,77,81,85,92
덕릉로30길,111,48,63,0,19,33,21,29,9
덕릉로42길,58,22,36,0,12,12,18,12,4
덕릉로54길,67,37,30,0,4,7,13,23,20
덕릉로59아길,59,20,39,0,2,7,21,24,5
덕릉로63가길,307,169,138,17,33,54,93,85,25
덕릉로73길,41,18,23,1,3,2,16,12,7
덕릉로83길,140,92,48,0,10,21,46,47,16
도곡로77길,303,84,219,0,41,140,61,43,18
도당로15길,281,119,162,1,27,57,87,77,32
도림로108나길,72,48,24,1,6,13,18,21,13
도림로113길,68,50,18,0,3,19,12,16,18
도림로12길,19,2,17,0,2,5,8,3,1
도림로147길,3003,1974,1029,14,558,801,773,587,270
도림로31길,483,278,205,2,57,91,128,144,61
도림로38길,51,26,25,0,8,12,10,13,8
도림로41길,189,81,108,0,16,27,58,54,34
도림로53길,111,43,68,0,17,17,30,29,18
도봉로109길,317,174,143,1,58,73,97,56,32
도봉로10다길,13,7,6,0,0,0,7,6,0
도봉로10라길,43,17,26,0,3,5,12,18,5
도봉로110길,525,168,357,2,114,116,124,113,56
도봉로113길,171,71,100,1,26,30,53,38,23
도봉로114길,95,41,54,0,6,14,33,26,16
도봉로13가길,196,78,118,2,43,39,39,38,35
도봉로13길,121,42,79,1,24,14,37,25,20
도봉로150길,211,52,159,1,16,26,34,87,47
도봉로152길,495,420,75,0,16,34,90,163,192
도봉로153길,634,340,294,16,111,152,180,121,54
도봉로156길,243,68,175,1,15,53,80,56,38
도봉로165길,147,36,111,1,17,14,24,43,48
도봉로169나길,233,96,137,2,22,35,55,63,56
도봉로18길,140,57,83,0,10,25,40,36,29
도봉로20가길,318,180,138,1,41,64,89,82,41
도봉로28길,89,49,40,0,9,18,31,21,10
도봉로29길,121,42,79,0,9,23,37,33,19
도봉로30길,99,45,54,0,12,17,36,26,8
도봉로35길,197,92,105,0,12,43,59,66,17
도봉로38길,134,70,64,1,21,23,37,40,12
도봉로46길,96,41,55,0,8,24,28,20,16
도봉로53길,383,151,232,4,51,59,115,87,67
도봉로57길,96,48,48,0,10,12,28,21,25
도봉로73길,64,29,35,0,3,6,19,23,13
도봉로78길,861,331,530,6,121,141,228,192,173
도봉로81길,338,185,153,1,39,35,65,77,121
도봉로87길,56,34,22,0,9,13,19,11,4
도봉로8길,50,28,22,2,12,10,9,9,8
도봉산3길,224,109,115,0,37,28,60,50,49
도신로15길,387,240,147,1,38,47,88,69,144
도신로19길,99,48,51,1,9,31,28,20,10
도신로29길,121,54,67,1,22,21,28,28,21
도영로7길,83,44,39,5,16,12,22,19,9
도화2길,21,7,14,0,7,6,5,2,1
도화4길,382,244,138,0,48,83,104,66,81
도화길,174,60,114,0,49,46,39,27,13
독립문로8길,311,114,197,0,34,58,71,96,52
독막로19길,361,242,119,1,99,142,70,31,18
독막로22길,294,72,222,7,131,83,45,14,14
독막로32길,296,161,135,6,34,69,94,49,44
독막로8길,396,264,132,5,82,113,86,64,46
독산로107길,118,49,69,0,4,16,19,42,37
독산로108길,1858,1457,401,3,113,128,141,255,1218
독산로10길,244,92,152,0,30,33,73,76,32
독산로22길,218,56,162,0,20,29,68,71,30
독산로28길,47,19,28,0,2,5,12,22,6
독산로32길,29,18,11,0,1,6,7,12,3
독산로35길,92,27,65,0,5,14,38,27,8
독산로36길,46,8,38,0,3,9,21,11,2
독산로38길,122,54,68,0,14,18,40,40,10
독산로39길,159,46,113,0,19,25,56,44,15
독산로40길,283,124,159,0,27,44,87,84,41
독산로44길,123,47,76,0,11,16,43,40,13
독산로64길,197,158,39,0,14,11,32,58,82
독산로70길,103,31,72,1,21,15,31,28,7
독산로74길,65,26,39,0,5,12,18,21,9
독산로80길,159,48,111,1,30,22,48,43,15
독산로85길,67,29,38,0,9,6,15,23,14
독산로87길,76,28,48,0,4,9,26,21,16
독서당로51길,263,127,136,1,60,73,48,48,33
돈화문로4길,515,357,158,2,44,112,126,123,108
돌곶이로22나길,178,51,127,0,23,45,67,39,4
돌곶이로23길,218,97,121,2,43,67,52,34,20
돌곶이로25길,309,212,97,0,12,31,53,57,156
돌곶이로27길,343,219,124,0,28,34,56,65,160
동광로12가길,365,144,221,3,192,66,46,37,21
동광로1길,2096,1375,721,2,410,761,507,285,131
동광로3길,394,268,126,4,71,97,102,69,51
동교로18길,531,232,299,1,108,187,154,50,31
동교로38길,41,22,19,0,15,18,6,2,0
동교로39길,68,36,32,0,15,20,18,10,5
동교로46길,45,24,21,0,15,25,2,1,2
동교로9길,2213,795,1418,8,192,257,227,314,1215
동남로81길,168,44,124,0,13,16,27,42,70
동남로8길,904,472,432,2,139,204,235,188,136
동산로12길,426,290,136,3,53,131,128,75,36
동산로13길,295,189,106,0,31,91,93,57,23
동산로19길,1570,656,914,2,148,484,561,270,105
동산로2길,125,83,42,0,23,30,32,23,17
동산로6길,1314,653,661,2,137,268,338,337,232
동소문로13가길,45,15,30,0,4,15,12,10,4
동소문로13길,99,48,51,0,36,26,15,9,13
동소문로13나길,474,293,181,3,86,80,97,101,107
동소문로23길,191,111,80,0,32,54,51,35,19
동소문로2길,1854,842,1012,2,182,271,337,624,438
동소문로5길,6,3,3,0,0,0,2,3,1
동소문로6길,2083,941,1142,2,229,318,392,675,467
동숭4나길,45,15,30,0,9,2,10,16,8
동숭길,991,693,298,2,137,303,231,227,91
동일로101길,227,100,127,0,19,50,61,75,22
동일로109길,309,141,168,1,31,58,83,95,41
동일로123길,169,78,91,1,17,28,55,33,35
동일로149길,818,489,329,1,67,105,130,136,379
동일로151길,127,77,50,0,15,31,33,38,10
동일로157길,308,186,122,2,44,80,83,69,30
동일로173가길,658,354,304,1,60,110,172,206,109
동일로178길,1469,791,678,3,194,279,326,390,277
동일로183길,733,448,285,11,96,118,154,208,146
동일로184길,71,42,29,0,10,18,23,15,5
동일로186길,699,527,172,0,44,86,133,168,268
동일로192길,363,219,144,2,36,40,82,111,92
동일로193길,131,73,58,2,20,15,33,33,28
동일로195길,233,112,121,1,22,45,61,73,31
동일로203가길,181,73,108,2,23,32,73,40,11
동일로207길,436,113,323,0,38,49,109,183,57
동일로208길,30,6,24,0,1,4,12,10,3
동일로217길,197,64,133,1,30,43,55,34,34
동일로231길,214,130,84,2,13,46,67,52,34
동일로239길,241,147,94,0,36,53,84,47,21
동일로241가길,49,28,21,0,6,11,20,10,2
동일로242가길,182,63,119,0,27,44,56,40,15
동일로242길,160,70,90,0,15,26,55,43,21
동일로242다길,92,27,65,0,11,21,33,20,7
동일로243길,122,56,66,2,16,33,35,30,6
동일로72길,162,89,73,1,18,52,42,33,16
동일로99길,254,110,144,0,26,62,59,76,31
동작대로7길,153,60,93,1,28,27,36,32,29
동호로11길,1190,643,547,12,359,356,247,143,73
동호로14길,2459,974,1485,49,1070,478,347,344,171
동호로15길,3560,1897,1663,167,1701,823,427,222,220
동호로25길,221,89,132,0,55,103,33,20,10
두산로13길,535,448,87,0,109,171,131,103,21
두산로5길,788,670,118,2,84,184,187,203,128
두텁바위로15길,5,4,1,0,0,0,0,1,4
두텁바위로58길,97,16,81,0,10,22,34,26,5
둘레15길,612,497,115,0,38,48,186,228,112
둘레길,952,705,247,1,86,130,283,310,142
등촌로39길,407,193,214,4,72,86,113,85,47
등촌로55길,390,254,136,0,41,71,56,100,122
등촌로5가길,186,78,108,3,29,39,51,44,20
디지털로27길,273,141,132,0,29,33,43,47,121
디지털로32길,16162,9510,6652,60,3772,6101,3913,1526,790
디지털로32나길,543,284,259,1,99,101,124,112,106
디지털로38길,779,296,483,4,89,205,341,109,31
디지털로54길,21,12,9,0,1,2,10,6,2
디지털로57길,51,22,29,0,14,9,12,9,7
뚝섬로27길,469,254,215,2,61,90,141,113,62
뚝섬로56길,95,41,54,0,8,26,27,21,13
마른내로12길,630,368,262,1,43,108,199,175,104
마방로4길,3923,2649,1274,26,735,1150,1116,573,323
마장로35길,541,330,211,2,66,120,166,151,36
마장로35나길,425,314,111,0,47,92,137,105,44
마장로9길,451,298,153,0,64,111,118,124,34
마천로51길,316,104,212,0,35,62,94,78,47
마천로57길,70,25,45,0,5,15,29,16,5
마천로7길,36,18,18,0,9,5,10,9,3
마포대로12길,171,52,119,0,40,50,44,26,11
마포대로14길,928,445,483,12,190,257,267,151,51
마포대로16길,132,70,62,0,30,33,28,25,16
마포대로4길,1780,959,821,1,220,431,438,467,223
만리재로24길,72,42,30,0,7,11,24,21,9
만리재로35길,90,55,35,0,17,17,24,18,14
만리재옛길,2407,1013,1394,22,699,698,577,277,134
망우로10길,33,24,9,1,1,11,8,4,8
망우로14길,76,31,45,0,20,17,18,16,5
망우로16길,140,48,92,3,24,29,36,27,21
망우로18다길,5,3,2,0,1,3,0,0,1
망우로32길,92,32,60,1,24,20,12,20,15
매봉길,46,24,22,1,12,10,8,10,5
면목로27길,147,68,79,0,16,31,48,34,18
면목로33길,207,105,102,0,14,34,59,68,32
면목로35길,44,18,26,0,12,6,13,8,5
면목로48길,150,66,84,0,21,40,42,35,12
면목로54길,144,67,77,0,12,36,42,39,15
면목로74길,83,29,54,0,13,10,27,26,7
면목로91길,141,51,90,0,29,28,35,28,21
면목로92길,462,139,323,1,24,62,268,96,11
면목천로23길,355,245,110,1,24,41,80,120,89
명동길,17931,8280,9651,17,2005,7870,5642,2136,261
명륜길,16,9,7,0,1,5,6,1,3
명지대길,260,212,48,1,10,23,49,90,87
목동남로4길,289,173,116,0,27,55,55,100,52
목동중앙남로10길,47,22,25,0,11,6,18,7,5
목동중앙남로13길,291,115,176,0,18,43,24,46,160
목동중앙남로4길,113,36,77,1,11,11,39,42,9
목동중앙본로7길,116,55,61,0,17,16,36,17,30
목동중앙북로7길,430,313,117,0,71,134,125,66,34
목동중앙북로8라길,498,181,317,2,21,29,64,113,269
목동중앙서로7길,154,61,93,0,15,18,40,36,45
무수막길,135,76,59,0,21,21,34,32,27
무학로14길,992,434,558,6,364,170,208,170,74
무학로30길,307,196,111,2,20,69,97,83,36
무학로43길,114,73,41,0,3,20,42,27,22
무학봉15길,84,35,49,2,18,18,23,13,10
무학봉길,172,78,94,3,23,32,52,37,25
문성로30길,14,8,6,0,3,2,4,5,0
미성길,121,61,60,0,10,19,38,33,21
바람드리길,309,135,174,4,23,67,86,80,49
바우뫼로37길,3081,2007,1074,8,450,907,673,520,523
바우뫼로39길,5727,3231,2496,21,852,1429,1394,1192,839
반포대로12길,264,181,83,2,28,54,68,40,72
반포대로19길,505,327,178,4,80,151,140,69,61
반포대로21길,414,272,142,0,66,120,120,53,55
반포대로22길,628,408,220,3,126,140,171,126,62
반포대로9길,2933,1714,1219,19,637,890,730,416,241
방배로15길,325,170,155,1,66,82,91,55,30
방배로23길,2777,1865,912,21,684,1111,670,191,100
방배로31길,2311,1511,800,5,332,565,527,454,428
방배로42길,258,98,160,0,58,60,61,38,41
방배로6길,486,345,141,0,58,134,153,92,49
방배천로4안길,636,430,206,1,51,112,139,185,148
방울내로7길,150,123,27,0,11,22,46,46,25
방학로6길,436,153,283,2,47,91,134,104,58
방화동로5길,250,126,124,3,42,66,74,40,25
백범로16길,126,55,71,2,15,22,44,24,19
백범로25길,162,75,87,0,30,29,47,36,20
백범로26길,416,196,220,111,202,56,23,13,11
백범로77길,368,216,152,8,53,97,100,58,52
백범로87길,523,330,193,8,130,143,118,91,33
백범로90다길,177,121,56,0,9,29,55,54,30
백범로90라길,269,164,105,0,25,57,65,78,44
백석동길,2127,1200,927,1,496,539,572,371,148
백제고분로12길,662,497,165,4,77,168,167,157,89
백제고분로18길,671,426,245,18,121,123,174,150,85
백제고분로19길,1156,770,386,4,185,325,263,183,196
백제고분로21길,513,306,207,0,67,116,107,97,126
백제고분로27길,796,453,343,0,103,186,248,165,94
백제고분로31길,1552,1294,258,3,75,155,230,183,906
백제고분로32길,3419,2001,1418,16,441,727,787,881,567
백제고분로34길,882,583,299,19,157,222,257,130,97
백제고분로39길,1425,747,678,8,283,336,333,279,186
백제고분로40길,1294,720,574,1,151,262,308,344,228
백제고분로41길,1810,1214,596,5,357,501,438,317,192
백제고분로42길,677,407,270,2,58,124,180,146,167
백제고분로45길,1048,707,341,2,151,271,256,230,138
백제고분로46길,570,355,215,0,63,81,130,122,174
백제고분로50길,1690,1073,617,10,291,481,463,262,183
범안로17길,699,513,186,3,46,76,165,252,157
법원단지5길,17,6,11,0,2,7,4,4,0
법원단지길,166,45,121,0,39,44,36,30,17
보국문로11길,156,67,89,1,18,26,56,44,11
보국문로16길,194,73,121,0,23,25,55,53,38
보국문로18길,140,46,94,0,12,18,34,44,32
보국문로8길,343,262,81,0,23,28,84,120,88
보라매로2길,332,209,123,0,27,40,63,68,134
보문로13다길,552,160,392,0,61,138,234,104,15
보문로19길,993,655,338,0,15,37,101,167,673
보문로23길,437,201,236,5,122,147,84,60,19
보문로29다길,31,15,16,0,5,7,11,1,7
보문로30가길,3002,1906,1096,4,290,828,914,698,268
보문로34길,96,48,48,0,29,21,17,14,15
보문로34나길,60,26,34,0,9,19,9,18,5
보문로37길,116,40,76,0,11,17,42,39,7
보문로3길,190,80,110,0,18,26,31,67,48
복은길,45,21,24,0,3,4,10,20,8
봉우재로14길,25,8,17,0,3,8,8,4,2
봉우재로28길,249,105,144,1,44,43,77,60,24
봉우재로33길,175,86,89,0,20,40,37,48,30
봉우재로70길,469,265,204,0,32,54,104,148,131
봉천로13길,50,14,36,0,4,10,16,15,5
봉천로23길,27,7,20,0,8,6,8,4,1
봉천로23나길,49,15,34,0,12,7,19,7,4
봉천로30길,66,42,24,0,25,16,7,8,10
봉천로31길,68,23,45,0,16,12,19,14,7
봉천로33길,80,52,28,1,3,10,18,11,37
봉천로6길,132,62,70,0,20,39,37,27,9
봉화산로30길,397,237,160,0,31,66,130,117,53
봉화산로4길,202,84,118,0,27,33,51,61,30
봉화산로56길,638,415,223,0,48,135,213,188,54
부일로15길,36,22,14,0,2,9,10,7,8
북아현로12길,16,8,8,0,1,2,6,4,3
북아현로14길,20,5,15,0,2,3,7,5,3
북촌로5가길,93,55,38,0,4,27,44,16,2
북촌로5나길,791,379,412,14,189,245,148,142,53
북촌로6길,106,39,67,0,39,23,16,15,13
불광로18길,2,1,1,0,0,0,0,2,0
불광로2길,1001,434,567,0,252,409,216,102,22
사가정로27길,124,75,49,0,28,28,33,25,10
사가정로51길,149,75,74,1,34,31,32,31,20
사근동11길,17,14,3,0,2,10,4,1,0
사근동8가길,12,6,6,0,0,2,3,1,6
사근동8길,32,17,15,0,4,5,15,6,2
사근동길,6594,3141,3453,3,1389,1618,1874,1303,407
사당로14가길,62,31,31,0,12,14,18,14,4
사당로16길,240,96,144,1,31,56,70,53,29
사당로17길,636,245,391,10,109,134,116,120,147
사임당로12길,565,347,218,2,103,192,135,81,52
사임당로1길,467,255,212,2,104,175,91,58,37
사직로12길,386,245,141,0,16,45,56,58,211
사직로8길,19,10,9,0,2,4,5,4,4
사평대로22길,781,401,380,0,198,211,171,117,84
사평대로28길,339,233,106,3,61,87,106,47,35
사평대로2길,1441,878,563,17,268,333,268,180,375
사평대로57길,123,38,85,3,48,29,20,16,7
살곶이8길,24,12,12,2,3,6,4,3,6
삼각산로22길,11,6,5,0,2,1,2,6,0
삼선교로10길,15,6,9,0,1,3,6,4,1
삼선교로14길,271,116,155,1,59,44,65,55,47
삼선교로23길,166,54,112,0,18,31,53,53,11
삼선교로4길,650,516,134,0,63,105,250,207,25
삼성로100길,2652,1415,1237,94,848,919,448,207,136
삼성로146길,135,59,76,0,37,47,34,7,10
삼성로64길,286,180,106,0,29,58,103,54,42
삼양로112길,94,22,72,0,19,19,23,18,15
삼양로139길,135,76,59,2,29,32,30,22,20
삼양로144길,580,196,384,0,129,95,143,153,60
삼양로173길,459,408,51,1,8,21,72,268,89
삼양로19길,345,86,259,0,47,66,125,72,35
삼양로20길,10,7,3,0,4,2,0,2,2
삼양로24길,26,15,11,0,0,3,8,4,11
삼양로27길,173,60,113,1,18,33,59,39,23
삼양로32가길,33,17,16,0,2,9,11,6,5
삼양로38길,90,44,46,2,19,17,13,22,17
삼양로73길,15,5,10,0,0,2,4,4,5
삼양로74길,61,24,37,0,4,2,14,25,16
삼양로77가길,77,37,40,0,28,14,13,13,9
삼양로8길,161,77,84,1,36,39,39,30,16
삼양로91길,20,4,16,0,1,0,4,11,4
삼양로93길,62,25,37,0,3,9,18,24,8
삼양로99길,16,11,5,0,1,3,5,4,3
삼일대로32가길,3209,2198,1011,5,474,1082,1015,445,188
삼일대로32길,9078,4594,4484,490,1631,2615,2776,1108,458
삼일대로4길,1172,449,723,23,299,313,233,167,137
삼청로5길,95,48,47,0,10,20,24,30,11
상계로12길,287,68,219,2,40,35,67,96,47
상계로37길,37,18,19,0,6,3,12,15,1
상계로9가길,45,27,18,0,2,6,15,16,6
상도로15길,281,143,138,1,19,51,86,69,55
상봉로11길,246,123,123,0,27,34,79,70,36
상원10길,206,120,86,0,27,47,48,51,33
상원길,3273,2115,1158,11,674,1013,861,492,222
상일로5길,74,32,42,0,5,13,31,21,4
새말로16길,1103,472,631,6,534,342,115,75,31
새창로33길,344,209,135,1,42,78,74,37,112
서강대길,282,174,108,5,34,76,82,66,19
서강로11길,213,96,117,0,44,56,27,34,52
서강로20길,23,14,9,0,4,6,4,6,3
서달로14길,71,26,45,2,8,13,21,20,7
서달로15길,30,14,16,1,1,5,10,6,7
서래로5길,1439,796,643,2,238,398,440,261,100
서림3길,22,17,5,0,1,5,7,3,6
서순라길,1561,961,600,2,327,319,298,356,259
서오릉로13길,363,179,184,0,42,74,121,88,38
서오릉로21길,1751,1060,691,2,114,238,401,752,244
서오릉로7길,128,50,78,0,9,30,35,42,12
서오릉로8길,129,41,88,0,7,14,43,34,31
서운로11길,739,516,223,3,137,217,173,129,80
서울숲2길,378,186,192,0,76,107,80,55,60
서울시립대로27길,90,52,38,1,3,18,37,19,12
서울시립대로29길,37,26,11,0,3,8,12,7,7
서울시립대로2길,180,108,72,1,24,28,53,46,28
서울시립대로5길,43,19,24,0,5,6,9,14,9
서초대로19길,2453,1553,900,8,331,563,571,526,454
서초대로1길,115,67,48,0,29,30,23,19,14
서초대로23길,2204,1178,1026,4,339,655,525,391,290
서초대로25길,2127,1321,806,23,519,663,544,258,120
서초대로26길,590,365,225,3,119,163,143,85,77
서초대로33길,1843,1048,795,9,429,534,444,256,171
서초대로34길,470,290,180,8,109,121,121,71,40
서초대로38길,1479,846,633,7,193,333,394,337,215
서초대로4길,495,362,133,6,67,135,142,81,64
서초대로54길,611,370,241,3,111,170,153,103,71
서초대로65길,18,12,6,2,2,3,8,2,1
서초중앙로31길,2039,1080,959,3,155,248,361,454,818
서초중앙로33길,2267,1136,1131,6,301,547,506,335,572
서해안로24길,54,12,42,0,1,6,17,10,20
석계로13길,107,62,45,0,20,22,32,20,13
석계로18길,57,35,22,0,11,14,11,10,11
석계로7길,131,36,95,2,10,11,24,41,43
석촌호수로18길,1061,566,495,7,113,219,311,300,111
선릉로130길,1743,333,1410,6,136,222,414,749,216
선릉로6길,138,66,72,0,20,34,31,37,16
선유로33길,183,127,56,0,24,59,48,36,16
선유로43가길,362,282,80,0,31,102,91,88,50
선유로9나길,107,77,30,0,4,16,30,32,25
선유서로25길,1183,943,240,2,113,255,330,290,193
성균관로9길,5,5,0,0,1,0,2,1,1
성대로1길,133,67,66,0,9,32,47,29,16
성덕정11길,218,143,75,0,19,38,62,70,29
성덕정19길,209,115,94,0,16,38,70,60,25
성덕정3길,74,46,28,0,2,11,26,28,7
성덕정길,1034,679,355,2,156,248,293,230,105
성미산로1길,799,568,231,3,113,187,201,124,171
성미산로29길,55,34,21,1,8,24,14,7,1
성북로14가길,33,14,19,0,4,6,10,9,4
성북로15길,141,108,33,0,8,36,49,37,11
성북로18길,122,46,76,0,23,22,29,31,17
성북로31길,135,49,86,2,29,27,26,28,23
성북로8길,486,159,327,1,41,209,176,39,20
성수이로7가길,1687,1035,652,10,323,534,488,240,92
성수일로1길,148,107,41,2,23,43,40,29,11
성수일로4길,3122,2164,958,20,661,986,801,481,173
성안로3길,4032,2539,1493,21,530,744,916,720,1101
성암로3길,44,34,10,0,4,4,9,13,14
성지3길,323,183,140,0,45,95,99,59,25
성지길,988,531,457,1,142,254,278,195,118
세검정로1길,256,78,178,0,31,50,81,39,55
세검정로3길,255,180,75,0,16,19,52,38,130
세무서7길,76,32,44,0,13,10,26,17,10
세무서길,264,92,172,1,28,56,87,59,33
세종대로2가길,1908,1049,859,15,309,633,439,259,253
소공로3길,347,182,165,1,43,54,70,106,73
소공로6길,111,65,46,1,27,29,20,16,18
소월로20길,28,13,15,0,2,7,6,6,7
소월로2길,12932,6240,6692,342,6380,2721,2486,851,152
소월로38가길,7,2,5,0,1,0,5,1,0
솔매로17길,20,4,16,0,4,8,2,1,5
솔매로36길,56,25,31,0,7,12,22,11,4
솔매로43길,57,25,32,0,6,4,22,18,7
솔매로44길,416,166,250,1,78,108,103,75,51
솔매로46길,349,158,191,1,54,91,84,70,49
솔매로50길,617,244,373,3,99,156,187,114,58
솔샘로18길,211,161,50,0,10,18,37,93,53
솔샘로1길,73,46,27,0,21,25,15,7,5
솔샘로47길,22,10,12,0,3,4,6,3,6
솔샘로48길,27,11,16,0,7,4,10,5,1
솔샘로4길,29,16,13,0,5,4,11,6,3
솔샘로64길,37,19,18,0,5,2,12,10,8
솔샘로65길,534,315,219,0,41,90,107,173,123
솔샘로67길,507,258,249,0,42,102,151,129,83
솔샘로68길,128,48,80,1,24,20,35,31,17
송월길,3248,945,2303,2,1112,1095,596,323,120
송파대로38길,441,255,186,0,71,104,83,140,43
수색로14길,85,35,50,0,8,18,23,21,15
수색로2길,422,109,313,0,78,104,120,69,51
수유로23길,374,110,264,0,48,63,90,125,48
수유로4길,531,365,166,2,70,89,115,126,129
숭문16길,19,10,9,0,2,3,4,7,3
숭문길,1465,876,589,6,108,222,260,513,356
숭인동길,206,84,122,0,20,26,38,69,53
승방길,578,457,121,5,48,105,203,115,102
시흥대로102길,236,141,95,0,26,46,54,63,47
시흥대로120길,125,57,68,0,13,24,48,31,9
시흥대로122길,386,291,95,0,63,79,119,71,54
시흥대로128길,395,308,87,0,63,76,113,83,60
시흥대로136길,36,16,20,0,2,2,11,18,3
시흥대로138길,204,154,50,0,55,46,33,57,13
시흥대로141길,243,134,109,0,22,35,84,59,43
시흥대로149길,113,46,67,0,6,14,47,33,13
시흥대로150길,248,108,140,10,44,64,55,46,29
시흥대로151길,406,272,134,0,22,79,161,105,39
시흥대로152길,563,320,243,11,68,102,136,135,111
시흥대로153길,682,435,247,3,75,151,217,166,70
시흥대로160길,5,3,2,0,0,1,1,0,3
시흥대로28길,474,307,167,1,27,56,118,129,143
시흥대로40마길,155,61,94,0,22,31,49,38,15
시흥대로47길,323,187,136,0,33,55,103,95,37
시흥대로50길,31,13,18,0,2,7,11,7,4
시흥대로68길,441,130,311,1,114,93,110,96,27
시흥대로71길,170,97,73,0,30,38,47,30,25
시흥대로72길,683,163,520,0,19,27,61,127,449
시흥대로88길,176,76,100,1,24,35,48,40,28
시흥대로94길,334,163,171,0,56,79,91,65,43
시흥대로96길,7,5,2,0,1,2,1,2,1
시흥대로98길,122,71,51,0,19,28,36,25,14
신길로23나길,62,21,41,0,4,9,17,19,13
신길로34길,54,31,23,1,6,11,12,8,16
신길로38길,326,194,132,6,30,87,110,61,32
신길로39길,61,34,27,0,13,8,18,14,8
신길로40길,331,173,158,5,47,98,103,57,21
신길로41길,357,139,218,1,55,75,100,79,47
신길로42가길,411,180,231,0,61,117,108,83,42
신길로60마길,26,5,21,0,8,8,7,3,0
신길로8길,40,10,30,2,7,9,10,8,4
신내로17길,319,187,132,0,23,46,95,99,56
신대방1가길,144,76,68,0,30,48,42,20,4
신도림로11길,495,325,170,3,63,95,122,140,72
신림동5가길,144,110,34,0,28,47,39,18,12
신림동길,225,152,73,0,38,68,61,32,26
신림로11길,55,24,31,0,20,12,13,6,4
신림로14길,167,52,115,0,13,40,56,47,11
신림로17길,54,22,32,0,1,18,15,11,9
신림로23길,87,50,37,1,6,17,22,19,22
신림로28길,271,206,65,1,7,23,61,105,74
신림로30길,73,57,16,0,5,13,21,23,11
신림로32길,39,19,20,0,3,5,9,15,7
신림로38길,61,26,35,0,8,13,18,12,10
신림로3가길,182,72,110,0,16,35,39,62,30
신림로48길,6827,3642,3185,1,946,2377,1660,1341,502
신림로58길,42,18,24,1,0,3,14,11,13
신림로64길,204,94,110,0,26,42,68,43,25
신림로65길,46,29,17,0,3,11,9,12,11
신림로73길,244,147,97,0,28,60,61,63,32
신목로2길,101,50,51,0,8,28,28,16,21
신목로4길,95,41,54,1,13,21,28,20,12
신목로5길,294,110,184,0,46,67,94,54,33
신반포로15길,131,81,50,0,11,35,45,14,26
신반포로45길,1863,1165,698,31,352,483,388,255,354
신원로3길,750,325,425,1,56,100,180,242,171
신원로4길,36,10,26,0,6,13,6,6,5
신월로15길,84,40,44,0,4,16,24,29,11
신월로16길,244,120,124,0,43,56,70,41,34
신이문로24길,11,1,10,0,0,7,1,3,0
신정중앙로23길,888,275,613,0,187,292,252,106,51
신촌로12길,24,15,9,0,5,4,5,5,5
신촌로1길,19,10,9,0,6,6,6,0,1
신촌로24길,94,31,63,0,30,23,15,17,9
신촌로30길,2709,1153,1556,31,681,757,576,460,204
신촌로37안길,507,139,368,1,62,74,106,150,114
신촌로3길,5,2,3,0,3,1,0,1,0
신촌로4길,249,97,152,0,59,82,71,30,7
신촌로9길,8,6,2,0,1,3,3,1,0
신풍로8길,52,25,27,0,1,12,15,17,7
신흥로20길,112,54,58,0,14,29,36,15,18
신흥안길,28,14,14,0,0,2,12,10,4
쑥고개로11길,114,42,72,1,9,16,33,34,21
아리랑로19길,75,32,43,0,7,18,15,20,15
아리랑로5길,171,60,111,1,26,24,29,56,35
아차산로51길,90,54,36,0,5,14,37,21,13
아차산로70길,57,47,10,0,2,1,5,9,40
아차산로76길,1787,936,851,8,456,652,375,189,107
아차산로7가길,65,36,29,0,10,14,18,16,7
아차산로7길,2893,1341,1552,28,592,836,734,456,247
안암로5길,165,103,62,0,22,28,49,48,18
안암로6길,234,141,93,0,39,65,63,38,29
안암로9가길,220,132,88,0,35,49,58,58,20
안암로9나길,312,200,112,0,40,66,101,70,35
압구정로29길,333,221,112,1,8,31,79,116,98
압구정로4길,498,288,210,4,135,139,134,58,28
약령서길,678,339,339,8,200,243,123,78,26
양녕로1길,258,165,93,5,42,49,59,50,53
양녕로2길,199,83,116,0,29,54,46,37,33
양산로19길,991,631,360,3,191,349,231,135,82
양산로23길,18,14,4,0,0,1,6,6,5
양재대로103길,468,246,222,0,62,117,115,90,84
양재대로124길,399,245,154,0,38,61,85,105,110
양재대로128길,112,48,64,0,8,14,36,27,27
양재대로85길,1052,665,387,1,156,314,269,219,93
양재천로19길,1508,1100,408,4,268,424,407,266,139
양천로14길,154,83,71,0,9,28,58,40,19
양천로49길,618,401,217,2,64,125,170,161,96
양천로57길,929,526,403,7,141,185,193,127,276
양천로69길,49,16,33,1,11,7,10,14,6
양평로17길,1727,945,782,5,473,533,384,234,98
양평로18길,672,374,298,2,88,140,206,160,76
양평로19길,656,333,323,7,103,140,165,168,73
양평로20길,607,335,272,2,77,123,170,152,83
양평로22길,677,368,309,0,123,138,190,150,76
양평로24길,1934,1181,753,2,395,613,476,274,174
양화로19길,56,31,25,1,9,18,16,9,3
양화로23길,46,21,25,1,6,8,13,7,11
양화로7길,1111,573,538,3,198,364,316,150,80
어울마당로1길,83,55,28,2,20,28,14,15,4
언남11길,658,459,199,4,101,157,207,120,69
언주로108길,684,423,261,7,165,241,165,71,35
언주로125길,620,361,259,1,125,169,152,80,93
언주로30길,3846,2384,1462,23,629,1363,1118,463,250
여의대방로13길,52,28,24,0,9,15,9,12,7
여의대방로24가길,595,370,225,5,94,156,125,99,116
여의대방로36길,628,330,298,0,73,144,180,161,70
여의대방로43가길,28,13,15,0,2,6,6,11,3
여의대방로55길,148,74,74,0,18,51,30,30,19
역말로9길,297,105,192,2,23,67,84,84,37
역삼로78길,576,320,256,0,109,136,151,119,61
연남로5길,1147,669,478,7,217,342,303,180,98
연대동문길,19502,7235,12267,61,4740,5970,4805,2993,933
연무장3길,6507,3297,3210,24,1604,2332,1505,944,98
연무장5가길,422,274,148,0,73,115,100,85,49
연무장길,5524,3721,1803,41,920,1431,1467,1148,517
연서로13길,165,54,111,0,21,25,42,60,17
연서로16길,188,81,107,3,41,42,53,28,21
연서로17길,547,215,332,0,48,101,174,156,68
연서로19길,451,220,231,0,42,107,146,102,54
연서로20길,504,168,336,0,60,111,159,102,72
연서로21길,410,154,256,2,76,99,106,89,38
연서로27길,533,275,258,1,54,71,108,135,164
연서로28길,320,165,155,0,41,87,82,58,52
연서로34길,101,23,78,1,15,28,24,26,7
연서로3길,482,148,334,0,26,69,104,207,76
연서로5길,446,130,316,1,22,66,89,196,72
연서로6길,424,246,178,0,54,118,112,88,52
연서로9길,218,80,138,0,20,36,63,78,21
연세로2길,2,1,1,0,0,0,1,0,1
연세로4길,6,1,5,0,0,1,3,0,2
연희로11가길,196,105,91,0,46,68,46,24,12
연희로15길,446,232,214,0,71,95,117,100,63
연희로25길,242,112,130,1,31,51,53,56,50
연희로41가길,81,68,13,0,8,36,29,8,0
연희로41길,163,111,52,0,10,46,56,26,25
연희로8길,103,42,61,0,23,30,20,24,6
영등포로13길,341,168,173,1,23,26,72,73,146
영등포로18길,413,272,141,0,68,86,56,74,129
영등포로25길,1379,733,646,6,114,298,347,318,296
영등포로27길,602,346,256,0,71,151,182,115,83
영등포로5길,438,283,155,0,51,72,98,127,90
영등포로62길,177,54,123,0,31,45,74,21,6
영등포로64길,145,81,64,0,20,34,26,55,10
영등포로72길,244,121,123,1,23,59,46,56,59
영등포로80길,2895,1662,1233,7,309,395,533,890,761
영등포로84길,615,196,419,2,78,130,142,169,94
영신로17길,57,36,21,0,9,8,18,12,10
영신로19길,91,40,51,0,10,10,40,21,10
영신로57길,159,103,56,1,15,32,47,40,24
영중로42길,5,1,4,0,0,2,1,1,1
오금로11길,527,343,184,6,67,127,118,119,90
오금로31길,141,85,56,0,17,34,32,28,30
오금로32길,24,12,12,0,1,1,4,11,7
오금로35길,881,423,458,8,105,152,207,302,107
오금로36길,1140,728,412,4,153,256,323,268,136
오금로46길,2276,1426,850,14,361,607,640,430,224
오류로8길,246,113,133,1,36,61,68,47,33
오목로54길,778,344,434,6,94,128,183,190,177
오패산로13길,124,68,56,0,28,27,29,29,11
오패산로19길,91,49,42,0,9,31,33,13,5
오패산로30길,141,85,56,0,18,28,38,21,36
오패산로31길,59,39,20,4,19,10,15,4,7
오패산로3길,1113,534,579,11,252,306,292,181,71
오패산로67길,275,157,118,1,37,56,82,52,47
오현로31길,1209,864,345,1,92,153,351,423,189
오현로32길,283,181,102,0,28,27,66,102,60
옥인6길,22,18,4,0,3,3,3,5,8
올림픽로32길,914,496,418,17,173,231,176,185,132
올림픽로35길,648,288,360,3,83,145,161,139,117
올림픽로4길,146,85,61,0,15,21,33,32,45
올림픽로62길,111,78,33,0,15,19,39,25,13
올림픽로92길,595,297,298,2,98,175,175,122,23
올림픽로98길,614,242,372,2,82,143,164,130,93
와우산로29길,227,147,80,1,57,48,59,39,23
와우산로29나길,71,33,38,0,16,19,22,8,6
와우산로30길,192,85,107,0,53,76,40,18,5
와우산로3길,86,57,29,0,9,36,22,14,5
왕산로22길,595,411,184,2,33,95,86,144,235
왕산로30길,117,57,60,0,14,16,41,23,23
왕산로32길,62,10,52,0,14,18,9,17,4
왕산로3길,203,90,113,0,38,54,49,42,20
왕산로45길,637,318,319,2,105,214,145,110,61
왕십리로14길,994,645,349,2,88,163,233,308,200
왕십리로26길,3584,2499,1085,14,588,814,968,743,457
왕십리로30길,1002,404,598,7,184,266,224,204,117
왕십리로33길,43,21,22,0,5,12,12,10,4
왕십리로5길,773,405,368,4,159,227,164,119,100
왕십리로6길,876,541,335,2,108,218,254,206,88
왕십리로8길,243,142,101,1,34,53,79,62,14
용답중앙11다길,332,272,60,0,91,85,47,55,54
용답중앙13길,425,297,128,0,108,103,77,79,58
용답중앙길,1963,1237,726,4,374,655,381,315,234
용마산로115길,763,361,402,0,130,196,192,141,104
용마산로117길,568,329,239,7,53,74,84,177,173
용마산로45길,83,28,55,0,17,19,30,17,0
우사단로10길,116,68,48,0,17,30,24,26,19
우사단로2길,64,45,19,0,4,7,20,18,15
우이천로4라길,563,282,281,2,79,108,171,118,85
원효로19길,490,346,144,0,60,180,136,69,45
원효로35길,341,239,102,8,34,92,109,59,39
원효로41길,1392,1020,372,0,78,144,239,565,366
원효로53길,347,210,137,1,30,64,79,53,120
원효로71길,192,113,79,0,26,47,66,41,12
원효로89길,308,160,148,1,38,67,83,62,57
월계로37길,228,124,104,6,32,32,59,58,41
월계로7나길,170,90,80,2,19,31,54,34,30
월곡로5길,205,93,112,5,31,43,38,51,37
월드컵로10길,1662,826,836,6,509,609,325,128,85
월드컵로14길,631,336,295,7,194,203,135,61,31
월드컵로23길,2261,697,1564,10,217,260,236,327,1211
월드컵로25길,597,357,240,0,84,157,183,102,71
월드컵로29길,795,469,326,4,100,217,216,145,113
월드컵로31길,543,254,289,0,82,136,140,122,63
월드컵로32길,781,416,365,9,182,181,177,149,83
월드컵로36길,1233,471,762,3,91,169,245,378,347
월드컵로3길,695,457,238,2,84,180,209,152,68
월드컵로7길,894,493,401,8,169,272,239,124,82
월드컵북로16길,2715,1847,868,14,357,513,495,434,902
월드컵북로30길,232,114,118,0,22,26,80,63,41
월드컵북로48길,345,214,131,0,60,112,99,51,23
월드컵북로4길,393,197,196,1,70,99,106,68,49
월드컵북로6길,1924,1104,820,10,346,552,496,331,189
월드컵북로7길,3761,2366,1395,35,627,871,911,918,399
위례성대로18길,3240,2126,1114,22,399,596,639,524,1060
위례성대로20길,269,138,131,0,35,73,74,47,40
율곡로10길,2016,1228,788,4,397,426,417,455,317
율곡로17길,885,435,450,5,131,225,227,211,86
율곡로19길,746,371,375,0,121,193,197,189,46
율곡로1길,1085,467,618,1,199,274,299,197,115
율곡로3길,1085,467,618,1,199,274,299,197,115
율곡로6길,7495,3552,3943,487,1351,2087,2215,955,400
은천로25길,61,26,35,0,2,7,23,19,10
은천로5길,130,79,51,0,31,32,38,23,6
은천로6길,894,493,401,3,215,151,172,214,139
은천로9길,83,33,50,0,7,18,16,25,17
은평로10길,170,79,91,2,26,37,27,53,25
은평로11길,408,217,191,1,41,71,108,106,81
은평로12길,269,130,139,2,39,60,60,66,42
은평로13길,565,235,330,3,61,105,152,144,100
은평로20길,219,89,130,1,41,49,62,32,34
은평로21길,81,40,41,0,12,16,23,20,10
은평로3길,165,91,74,1,21,32,56,33,22
은평로6길,448,198,250,2,56,94,129,130,37
은평로8길,243,108,135,1,47,49,68,58,20
은평로9길,711,471,240,0,72,137,198,238,66
을지로22길,270,193,77,2,51,48,64,69,36
을지로30길,442,292,150,2,47,92,139,109,53
을지로32길,296,209,87,1,25,56,88,84,42
응암로11길,471,264,207,5,120,91,114,100,41
응암로12길,168,80,88,1,18,31,70,36,12
응암로13길,148,52,96,1,13,24,45,39,26
응암로14길,103,44,59,0,12,21,33,22,15
응암로1길,470,310,160,2,88,111,122,108,39
응암로20길,280,149,131,0,22,113,87,44,14
응암로22길,337,174,163,0,31,123,101,53,29
응암로29길,336,174,162,1,43,61,77,92,62
응암로34길,313,139,174,0,40,62,92,77,42
응암로9길,150,63,87,0,18,25,48,46,13
이문로12길,18,14,4,0,0,4,8,5,1
이문로24길,18,6,12,1,3,1,5,8,0
이문로25길,5,3,2,0,0,0,4,1,0
이문로28길,54,16,38,0,6,11,9,19,9
이문로42길,34,12,22,1,9,3,4,10,7
이촌로14길,93,55,38,0,32,33,14,11,3
이촌로22길,64,41,23,0,4,13,16,13,18
이태원로17길,278,143,135,3,125,90,29,13,18
이태원로20가길,73,35,38,0,16,20,11,13,13
이태원로20길,33,18,15,0,12,8,5,4,4
이태원로26길,13,10,3,0,3,4,3,1,2
이태원로27길,385,240,145,7,180,83,48,40,27
이태원로36길,164,81,83,0,43,37,49,21,14
이태원로42길,2735,1369,1366,20,527,1111,721,308,48
이화장길,2966,1693,1273,11,479,856,751,632,237
인수봉로55길,26,13,13,0,2,4,8,7,5
인수봉로56길,21,10,11,0,0,5,3,6,7
인수봉로67길,52,15,37,0,9,7,7,14,15
인수봉로68길,306,157,149,0,18,52,91,100,45
인수봉로77길,17,4,13,0,5,1,5,5,1
인수봉로78길,118,75,43,1,4,21,42,28,22
인수봉로79길,104,37,67,0,17,9,31,31,16
인촌로17가길,12,9,3,0,1,1,5,3,2
인촌로1길,448,241,207,0,163,86,103,68,28
인촌로24가길,14,5,9,0,1,5,5,1,2
인촌로24길,141,52,89,0,46,32,36,16,11
인촌로27길,175,89,86,1,30,45,45,41,13
인촌로28길,161,60,101,3,38,33,47,17,23
인촌로7다길,3973,2402,1571,12,589,1032,1134,862,344
인헌3길,40,9,31,0,7,5,17,7,4
인헌4길,108,46,62,0,11,23,35,26,13
인헌6길,289,108,181,1,64,66,69,59,30
인헌길,534,262,272,1,62,107,143,152,69
일원로9길,676,355,321,2,56,125,155,159,179
자동차시장1길,1703,1234,469,6,358,708,421,151,59
자양로15길,1501,690,811,8,346,322,300,203,322
자양번영로1길,367,329,38,0,11,31,115,148,62
자하문로10길,133,41,92,0,48,38,26,14,7
자하문로24길,205,90,115,0,44,67,51,37,6
자하문로41길,144,77,67,0,22,30,47,31,14
자하문로5길,3,0,3,0,0,0,3,0,0
자하문로7길,94,44,50,0,15,29,23,17,10
자하문로9길,180,96,84,1,32,75,44,17,11
잔다리로7안길,3243,1288,1955,9,815,1356,747,216,100
잠원로14길,82,58,24,1,3,11,11,17,39
장군봉1길,363,189,174,0,44,88,121,67,43
장군봉2길,193,131,62,0,11,37,48,57,40
장문로45길,262,139,123,0,28,39,51,76,68
장문로6길,2,1,1,0,0,0,1,0,1
장월로1길,1065,493,572,1,207,211,268,261,117
장월로1마길,196,76,120,0,20,40,33,75,28
장월로3길,15,9,6,0,0,3,7,2,3
장위로38길,80,43,37,0,6,9,21,28,16
장위로40길,29,19,10,0,0,4,5,14,6
장충단로8길,3201,1704,1497,11,503,819,1082,630,156
장터2길,98,48,50,0,8,31,18,20,21
장터3길,353,138,215,0,49,75,70,99,60
장터5길,56,25,31,0,12,13,10,14,7
장터길,186,62,124,0,30,44,30,45,37
장한로18길,390,208,182,0,58,118,109,79,26
장한로25길,299,86,213,4,61,59,54,86,35
장한로32길,765,500,265,0,98,106,170,235,156
장한로5길,569,317,252,0,99,182,144,85,59
전농로16길,160,69,91,0,15,48,49,29,19
전농로17길,80,51,29,0,10,19,21,21,9
전농로20길,245,96,149,3,24,84,79,42,13
전농로27길,369,213,156,0,51,59,118,92,49
전농로29길,177,96,81,0,31,23,48,45,30
전농로37길,198,107,91,7,33,34,57,45,22
전농로3길,212,67,145,0,25,23,41,55,68
정릉로10길,410,362,48,0,24,43,138,154,51
정릉로26길,55,28,27,0,4,10,17,17,7
정릉로27길,253,199,54,1,19,25,63,84,61
정릉로31길,9,3,6,0,3,3,3,0,0
정릉로31나길,63,23,40,0,8,14,18,15,8
정릉로6길,33,28,5,0,0,7,4,7,15
제기로20길,200,101,99,1,24,44,43,43,45
제기로2길,16,9,7,0,1,0,10,2,3
제기로38길,601,286,315,2,108,208,146,94,43
제기로5길,196,97,99,0,8,33,57,71,27
조원로12길,231,125,106,2,27,34,53,60,55
조원로13길,138,60,78,0,8,27,45,40,18
조원로18길,190,116,74,1,22,29,53,52,33
조원로31길,313,156,157,0,33,75,86,69,50
조원로6길,175,99,76,0,19,35,38,51,32
조원중앙로2길,379,184,195,3,46,69,104,109,48
종로24길,515,357,158,2,44,112,126,123,108
종로26길,247,175,72,2,22,58,73,50,42
종로41길,149,79,70,0,23,28,38,34,26
종로44길,456,312,144,1,48,118,125,81,83
종로51가길,19,6,13,0,1,1,5,11,1
종로57길,105,50,55,0,15,27,24,27,12
종로58가길,377,177,200,3,86,97,77,55,59
종로5길,10225,8438,1787,22,1331,3646,2708,1852,666
종로63길,170,78,92,0,20,36,53,33,28
종로65길,292,115,177,0,27,47,96,67,55
종암로14길,221,73,148,2,46,47,53,41,32
종암로19길,142,71,71,0,26,34,39,33,10
종암로27길,1077,753,324,4,131,267,327,299,49
종암로5길,141,45,96,0,22,43,43,19,14
주흥13길,27,16,11,0,6,4,9,4,4
주흥길,980,595,385,7,155,260,266,168,124
중계로18길,181,87,94,0,24,41,53,38,25
중대로9길,2134,1547,587,4,232,572,651,433,242
중랑역로13길,12,7,5,0,0,0,5,5,2
중랑천로10길,901,543,358,16,183,165,213,196,128
중랑천로12길,816,479,337,16,197,142,183,180,98
중림로5길,755,316,439,2,338,196,156,62,1
중앙1길,281,126,155,1,74,79,53,47,27
중앙길,89,20,69,0,9,22,26,21,11
중앙로1길,1065,736,329,3,117,140,164,182,459
중앙로34길,165,64,101,0,16,24,66,39,20
중앙로45길,177,56,121,2,19,27,38,51,40
중앙로46길,291,114,177,0,21,48,85,75,62
중앙로6길,624,205,419,1,154,126,140,141,62
증가로10길,160,76,84,1,21,29,39,49,21
증가로12나길,63,26,37,0,8,11,22,15,7
증가로20길,88,28,60,0,19,16,25,16,12
증가로24바길,23,10,13,0,3,4,6,9,1
증가로25길,79,37,42,0,2,14,25,30,8
증가로29길,336,150,186,2,103,119,72,27,13
증가로8길,65,31,34,0,14,18,11,14,8
증산로15길,367,111,256,0,8,23,62,84,190
증산로17길,605,314,291,0,12,32,89,165,307
증산로23길,301,154,147,1,52,61,63,84,40
증산로3길,282,113,169,3,33,56,81,67,42
증산로9길,805,559,246,5,96,143,166,208,187
증산서길,915,622,293,2,68,131,223,261,230
지봉로17길,92,32,60,2,13,10,24,36,7
지양로3길,26,10,16,0,2,6,9,6,3
진흥로12길,76,20,56,1,9,11,15,31,9
진흥로1길,209,81,128,0,31,37,45,67,29
진흥로7길,253,127,126,2,33,49,64,72,33
창경궁로13길,331,219,112,0,44,68,99,71,49
창경궁로1길,608,418,190,3,53,104,179,181,88
창경궁로27길,60,30,30,0,8,16,15,10,11
창경궁로35길,1921,630,1291,9,492,449,493,279,199
창경궁로43길,3,1,2,0,0,0,2,0,1
창덕궁1길,12,1,11,0,1,2,5,2,2
창덕궁길,867,430,437,7,121,260,225,191,63
창신3길,32,18,14,0,2,9,7,10,4
창신6길,78,29,49,0,2,13,11,30,22
창신길,256,71,185,1,25,33,39,91,67
창의문로11길,23,11,12,0,4,9,3,2,5
천장산로4길,29,18,11,0,10,2,4,9,4
천장산로7길,30,15,15,0,4,6,10,7,3
천장산로9길,40,16,24,0,8,9,9,9,5
천중로40길,605,350,255,2,94,183,113,128,85
천중로50길,903,536,367,1,83,155,219,214,231
천호대로111길,699,381,318,1,148,191,159,134,66
천호대로134길,75,39,36,0,13,18,19,13,12
천호대로13길,474,264,210,0,94,128,88,86,78
천호대로16길,463,270,193,0,96,74,113,125,55
천호대로170길,792,487,305,0,64,114,163,249,202
천호대로17길,341,237,104,4,20,69,83,99,66
천호대로27길,91,44,47,0,9,20,23,19,20
천호대로77나길,111,58,53,0,10,27,35,26,13
천호옛14길,177,76,101,5,24,40,46,33,29
청계천로10나길,540,363,177,2,66,159,164,100,49
청계천로12가길,5190,3721,1469,15,426,873,1281,1827,768
청구로17길,286,175,111,0,48,83,69,62,24
청구로21길,1081,722,359,5,141,364,262,209,100
청구로3길,1451,788,663,7,248,324,343,264,265
청두곶길,1140,841,299,48,453,332,207,60,40
청룡3길,189,125,64,1,32,38,50,42,26
청룡4길,130,63,67,1,15,22,36,35,21
청룡7길,379,271,108,1,48,77,115,86,52
청룡8길,371,209,162,3,29,56,113,103,67
청룡길,519,387,132,0,35,89,154,133,108
청룡중앙길,71,47,24,0,6,5,8,14,38
청림2길,81,30,51,2,16,18,18,14,13
청림5길,695,311,384,0,81,223,195,110,86
청림길,130,73,57,2,26,39,23,23,17
청파로43길,41,23,18,0,4,8,10,9,10
청파로45길,26,11,15,0,1,3,8,5,9
청파로47길,312,180,132,2,39,78,83,65,45
청파로49길,146,97,49,1,26,34,40,22,23
청파로85길,187,87,100,0,38,59,45,30,15
청파로93길,164,69,95,2,35,46,35,32,14
청황길,28,16,12,0,1,4,9,8,6
초록마을로8길,199,68,131,1,22,39,55,44,38
충정로4길,4428,2046,2382,18,965,1837,1052,350,206
충정로5길,430,305,125,1,68,105,128,82,46
충정로6길,2042,1243,799,0,120,574,843,491,14
충정로9길,407,299,108,2,45,92,132,96,40
탑골로2길,86,37,49,1,6,19,21,28,11
탑골로4길,195,64,131,0,31,52,46,54,12
토정로11길,624,326,298,2,97,140,118,144,123
토정로31길,2113,1089,1024,8,465,534,512,353,241
토정로37길,1676,857,819,6,328,413,400,251,278
통일로12길,110,64,46,1,14,19,24,26,26
통일로14길,440,113,327,0,119,135,103,47,36
통일로25길,92,33,59,0,25,18,23,15,11
통일로37길,366,118,248,0,77,102,102,54,31
통일로39가길,217,106,111,0,12,22,47,71,65
통일로40길,114,32,82,0,7,13,23,26,45
통일로63길,86,25,61,0,5,11,34,20,16
통일로66길,13,2,11,0,0,4,0,7,2
통일로67길,171,58,113,2,27,37,46,32,27
통일로68길,190,89,101,3,24,56,55,30,22
통일로69길,69,27,42,0,2,10,32,13,12
통일로71길,52,23,29,0,4,11,17,12,8
통일로73길,207,97,110,0,19,21,51,57,59
통일로77길,82,40,42,1,12,25,24,10,10
통일로78길,400,131,269,6,81,88,86,88,51
통일로83길,404,205,199,4,44,108,116,79,53
통일로85길,234,108,126,4,19,52,69,59,31
통일로87길,274,156,118,2,25,43,70,87,47
통일로92길,300,68,232,1,38,52,104,72,33
퇴계로10길,98,45,53,0,13,24,17,23,21
퇴계로20길,7762,2741,5021,36,2888,3323,1150,280,85
퇴계로28길,696,347,349,1,243,149,139,112,52
퇴계로32길,186,95,91,0,20,50,53,36,27
퇴계로46길,284,198,86,0,23,75,75,67,44
퇴계로4길,1044,435,609,9,214,305,233,165,118
퇴계로53길,591,242,349,8,373,111,48,32,19
퇴계로56길,204,133,71,0,18,44,54,52,36
퇴계로74길,209,76,133,0,37,39,47,56,30
퇴계로76길,425,172,253,2,83,76,101,104,59
퇴계로83길,131,98,33,1,10,42,36,29,13
퇴계로87길,1333,830,503,5,261,326,266,282,193
퇴계로88길,2296,994,1302,14,590,967,528,119,78
퇴계로8길,16634,7852,8782,67,2239,5772,5303,3002,251
퇴계로90길,508,189,319,1,78,134,121,114,60
팔판길,95,48,47,0,10,20,24,30,11
평창11길,397,188,209,1,43,86,74,105,88
평창길,506,236,270,0,50,117,105,119,115
포방터길,42,20,22,0,3,10,13,7,9
풍성로25길,30,16,14,0,5,3,7,7,8
풍성로37가길,135,29,106,0,23,32,25,31,24
풍성로54길,77,29,48,2,8,14,30,16,7
필운대로1길,470,174,296,0,46,138,149,79,58
필운대로5가길,52,21,31,0,11,19,13,9,0
필운대로6길,588,256,332,3,192,222,100,40,31
필운대로7길,13,8,5,0,1,2,9,0,1
학동로20길,521,307,214,4,120,148,146,61,42
한강대로104마길,23,10,13,0,2,5,4,7,5
한강대로10길,78,30,48,0,12,23,19,17,7
한강대로15길,861,464,397,4,140,197,183,193,144
한강대로21길,384,186,198,0,36,52,57,136,103
한강대로23길,134,68,66,1,5,22,19,35,52
한강대로38길,4264,3357,907,0,230,1036,1794,1156,48
한강대로40길,4885,3657,1228,2,310,1151,1949,1330,143
한강대로43길,875,488,387,4,115,224,267,151,114
한강대로52길,690,475,215,0,118,201,152,115,104
한강대로62가길,673,255,418,1,67,195,198,174,38
한강대로62길,714,439,275,0,114,227,174,122,77
한강대로62다길,5217,3538,1679,11,586,1274,1983,1273,90
한강대로7길,1855,542,1313,36,803,537,178,110,191
한강대로88길,1626,1137,489,7,206,418,377,261,357
한강대로96길,26,3,23,1,5,8,2,7,3
한글비석로1길,182,70,112,1,12,40,35,52,42
한글비석로20길,180,101,79,0,12,32,58,53,25
한글비석로23길,234,79,155,0,43,41,54,62,34
한글비석로46길,266,109,157,2,32,39,83,63,47
한글비석로48길,44,18,26,0,1,7,12,15,9
한남대로20길,328,163,165,0,107,132,45,28,16
한남대로21길,60,29,31,0,11,15,18,8,8
한남대로27길,329,169,160,4,111,102,58,30,24
한남대로42길,240,138,102,0,67,72,54,28,19
한림말1길,228,141,87,0,39,47,63,55,24
한림말3길,148,83,65,0,22,25,41,39,21
한림말길,300,106,194,0,44,56,89,81,30
한천로101가길,210,118,92,0,23,36,56,67,28
한천로11길,814,502,312,0,98,141,194,198,183
한천로130길,236,120,116,1,16,53,69,57,40
한천로131길,234,132,102,0,19,30,53,73,59
한천로132길,339,141,198,2,50,66,88,83,50
한천로143길,1923,1025,898,1,169,548,488,570,147
한천로144길,141,74,67,0,11,23,36,38,33
한천로14길,1795,1113,682,20,360,421,456,356,182
한천로150길,184,104,80,0,19,32,45,52,36
한천로155길,376,140,236,0,31,50,94,99,102
한천로170길,215,81,134,3,25,31,54,66,36
한천로17길,196,130,66,0,31,44,74,22,25
한천로18길,149,63,86,0,20,34,28,38,29
한천로24길,743,424,319,1,99,188,203,177,75
한천로33길,286,100,186,0,23,43,105,83,32
한천로36길,247,118,129,1,28,45,66,71,36
한천로46길,224,111,113,1,55,47,61,37,23
한천로78길,187,111,76,1,13,35,63,47,28
한천로80길,84,67,17,1,6,11,29,27,10
해등로16길,183,71,112,0,30,44,65,34,10
해등로26길,64,16,48,0,16,12,14,14,8
행당로17길,207,88,119,0,37,51,50,41,28
행당로1길,117,29,88,0,17,40,35,19,6
행당로8길,146,39,107,0,10,32,43,53,8
행운1길,478,262,216,3,97,128,125,78,47
행운길,1031,703,328,13,165,288,257,199,109
혜화로14길,218,92,126,0,55,76,37,22,28
혜화로3길,22,14,8,0,8,2,5,4,3
호암로18길,26,13,13,0,0,4,8,8,6
호암로22길,64,31,33,1,2,16,21,13,11
호암로26길,628,223,405,0,72,105,142,181,128
홍릉로29길,27,10,17,0,3,5,5,9,5
홍릉로5길,253,123,130,2,20,46,77,72,36
홍연길,127,77,50,0,3,15,50,46,13
홍은중앙로8길,34,17,17,0,5,8,8,6,7
홍은중앙로9길,179,66,113,1,22,36,42,56,22
홍제내2나길,92,37,55,0,9,13,29,27,14
홍제내길,237,145,92,0,19,38,71,75,34
홍제천로2길,46,31,15,0,6,8,14,13,5
홍지문2길,90,10,80,0,9,7,16,50,8
홍지문길,118,35,83,0,9,13,18,53,25
화계사길,537,522,15,0,5,51,204,231,46
화곡로15길,319,139,180,0,27,58,79,99,56
화곡로20길,290,129,161,3,44,52,79,82,30
화곡로25길,273,129,144,2,44,57,57,62,51
화곡로31길,165,83,82,0,30,47,43,24,21
화곡로42길,120,52,68,0,6,32,33,24,25
화랑로11길,40,19,21,0,8,12,7,10,3
화랑로18나길,29,21,8,0,4,3,9,12,1
화랑로19길,108,56,52,0,3,12,30,38,25
화랑로25길,41,19,22,0,4,17,8,5,7
화랑로32길,728,469,259,9,127,233,197,112,50
화랑로40길,256,173,83,1,22,40,66,83,44
화랑로43길,78,32,46,1,15,12,25,17,8
화랑로45길,63,11,52,0,0,2,10,28,23
화랑로47길,50,2,48,0,0,1,6,25,18
화랑로51길,221,87,134,0,19,24,50,82,46
화랑로53길,2,2,0,0,0,0,0,1,1
화랑로5길,369,141,228,0,59,86,113,81,30
환일길,160,84,76,0,24,59,43,22,12
황물로15길,598,428,170,0,65,132,179,138,84
황물로3길,772,544,228,5,139,170,164,134,160
회기로21길,38,20,18,0,1,16,12,7,2
회기로23길,95,47,48,0,10,33,26,17,9
회기로28길,175,99,76,0,20,39,34,38,44
회기로29길,162,70,92,0,30,26,55,40,11
회나무로13길,124,50,74,0,23,30,32,20,19
회나무로13나길,423,261,162,0,66,211,101,27,18
회나무로44길,392,215,177,5,166,121,53,22,25
효령로29길,792,331,461,3,239,136,138,166,110
효령로34길,1731,1046,685,42,474,489,341,228,157
효령로40길,894,533,361,2,181,309,247,112,43
효령로67길,3599,1511,2088,13,1268,1039,674,421,184
효령로68길,562,374,188,2,79,157,180,101,43
효령로74길,562,406,156,2,111,177,134,81,57
효창원로39길,64,24,40,1,17,14,15,11,6
효창원로62길,233,129,104,1,41,78,66,27,20
효창원로8길,283,203,80,2,36,115,78,32,20
효창원로93길,794,463,331,0,57,206,273,225,33
효창원로98길,599,393,206,0,47,88,171,161,132
후암로23길,61,33,28,0,1,9,13,29,9
후암로30길,42,15,27,1,12,7,7,11,4
후암로35길,64,33,31,0,5,11,14,24,10
후암로4길,1396,725,671,0,176,266,286,499,169
휘경로23길,59,24,35,0,3,9,15,19,13
휘경로2길,151,63,88,3,28,37,33,35,15
휘경로3길,119,48,71,1,30,24,26,28,10
희우정로16길,169,102,67,1,31,42,60,24,11
