상권코드명,총상주인구수,남성상주인구수,여성상주인구수,연령대10상주인구수,연령대20상주인구수,연령대30상주인구수,연령대40상주인구수,연령대50상주인구수,연령대60이상상주인구수
가락로16길,599,302,297,72,91,99,90,110,137
가락로28길,293,127,166,51,38,45,49,48,62
가락로36길,2188,1110,1078,441,295,402,450,294,306
가로공원로76길,2043,969,1074,339,270,395,317,302,420
가마산로61길,1362,702,660,165,211,154,221,269,342
가마산로88길,322,159,163,24,57,71,45,59,66
가마산로89길,307,155,152,31,71,48,48,48,61
가산로3길,2945,1760,1185,185,769,932,438,322,299
가산로5길,1685,1002,683,136,432,453,220,218,226
가재울로14길,433,207,226,54,65,56,61,79,118
가재울로4길,1043,509,534,138,155,141,175,155,279
가재울로6길,1274,655,619,176,170,188,211,193,336
가좌로6길,1352,666,686,182,187,154,191,272,366
가좌로7길,2475,1257,1218,324,335,276,395,442,703
가좌로7다길,2906,1438,1468,398,383,336,468,498,823
가좌로9길,1665,802,863,185,227,317,274,265,397
갈현로1길,2242,1085,1157,383,291,362,401,352,453
갈현로23길,3528,1693,1835,597,469,564,583,594,721
갈현로29길,3309,1605,1704,632,473,439,557,575,633
갈현로33길,3430,1709,1721,596,519,505,567,576,667
갈현로3길,2761,1355,1406,494,331,457,486,424,569
갈현로41길,2864,1435,1429,373,423,348,418,509,793
갈현로4길,3905,1855,2050,700,510,663,665,568,799
강남대로107길,148,71,77,10,34,36,21,22,25
강남대로83길,1141,515,626,66,246,338,172,138,181
강남대로89길,152,79,73,11,18,38,35,25,25
강남대로8길,6807,3353,3454,961,1095,1540,1113,972,1126
강동대로9길,536,260,276,79,84,110,80,76,107
강서로17다길,7629,3772,3857,1037,1149,1589,1114,1232,1508
강서로18길,7462,3641,3821,1233,1075,1454,1273,1008,1419
강서로18다길,1181,546,635,151,144,239,194,175,278
강서로39길,563,317,246,56,77,76,93,114,147
강서로45길,2935,1425,1510,612,419,448,517,439,500
강서로47가길,991,486,505,197,146,127,185,175,161
강서로47길,2583,1220,1363,506,365,342,491,434,445
강서로48길,1150,543,607,263,160,153,229,180,165
강서로74길,224,120,104,28,36,71,38,21,30
강서로8길,4856,2345,2511,669,652,967,716,762,1090
개봉로2길,2591,1240,1351,446,323,481,405,379,557
개봉로3길,8859,4342,4517,1415,1173,1410,1473,1435,1953
개포로109길,573,273,300,86,69,152,90,90,86
개포로82길,38,28,10,0,5,12,8,7,6
거북골로16길,550,290,260,72,76,66,85,104,147
거북골로20길,2557,1214,1343,391,349,378,427,422,590
경기대로9길,625,319,306,78,121,85,98,106,137
경인로22길,675,354,321,45,183,231,82,56,78
경인로35길,3474,1777,1697,432,447,420,526,673,976
경인로40길,1231,583,648,176,122,210,174,176,373
경인로47길,1607,868,739,205,225,238,262,270,407
경인로47다길,1088,565,523,147,161,127,180,186,287
경인로59길,561,276,285,73,100,116,107,68,97
경희대로1길,322,162,160,25,129,52,28,29,59
경희대로3길,660,333,327,55,254,118,71,55,107
경희대로4길,628,288,340,65,194,97,76,79,117
경희대로6길,399,195,204,44,107,70,64,39,75
고덕로10길,1408,680,728,234,201,267,236,225,245
고산자로14길,330,145,185,20,116,91,41,30,32
고산자로16길,58,33,25,3,3,7,8,13,24
고산자로2길,684,325,359,158,58,131,161,74,102
고산자로31길,205,123,82,7,35,13,28,40,82
고산자로6길,372,192,180,53,54,54,59,59,93
고산자로8나길,1939,1006,933,187,299,284,305,350,514
고척로21나길,3524,1774,1750,538,469,459,539,618,901
고척로27길,2603,1310,1293,367,365,389,427,460,595
고척로33길,2676,1306,1370,403,413,328,454,474,604
고척로52길,2559,1278,1281,460,358,361,444,420,516
곰달래로31가길,4004,1988,2016,665,496,729,734,584,796
곰달래로31길,8952,4257,4695,1568,1077,1763,1566,1235,1743
곰달래로35길,4929,2393,2536,859,691,992,866,692,829
곰달래로60길,728,356,372,59,124,146,109,117,173
공릉로12가길,969,485,484,168,142,129,168,157,205
공릉로12길,520,252,268,79,73,81,78,88,121
공릉로2길,3192,1553,1639,385,448,520,481,510,848
공릉로34길,1868,941,927,349,289,306,330,279,315
공릉로58가길,345,143,202,70,78,23,56,68,50
공릉로59나길,935,455,480,212,133,112,179,153,146
공릉로65길,48,27,21,12,9,4,15,3,5
공항대로41길,269,162,107,27,44,45,39,45,69
공항대로42길,898,436,462,139,127,145,143,157,187
공항대로45길,3582,1643,1939,343,920,1108,488,395,328
공항대로55길,1550,729,821,220,392,404,216,165,153
공항대로61길,1290,644,646,166,208,264,192,229,231
공항대로7길,1194,608,586,155,197,166,181,221,274
관악로11길,2540,1276,1264,249,807,507,320,261,396
관악로14길,1515,765,750,115,496,352,176,149,227
관악로24길,254,125,129,31,47,54,36,31,55
관악로28길,797,415,382,142,129,135,128,110,153
관천로11길,5748,2967,2781,615,1115,1010,914,945,1149
광나루로11길,2152,1167,985,269,344,296,335,428,480
광나루로12길,181,92,89,24,43,27,24,27,36
광나루로56길,392,202,190,84,68,42,70,84,44
광성로4길,261,139,122,33,65,34,44,31,54
광운로2길,298,166,132,32,82,35,41,38,70
광운로3길,327,187,140,41,101,49,33,45,58
광평로19길,877,412,465,153,120,154,155,128,167
구로동로28길,2631,1349,1282,268,271,302,444,512,834
구로동로29길,1642,823,819,122,158,195,269,359,539
구로동로35길,717,374,343,63,81,126,115,137,195
구로동로42길,985,481,504,140,126,128,177,172,242
구로중앙로19길,491,243,248,61,66,61,72,90,141
구로중앙로28길,3342,1687,1655,392,510,568,568,583,721
구로중앙로7길,1051,523,528,146,101,150,167,180,307
구로중앙로8길,1537,754,783,192,167,171,259,294,454
구일로10길,1392,704,688,251,166,377,260,181,157
국제금융로7길,1441,682,759,274,176,211,227,192,361
국회단지길,3714,1828,1886,522,539,648,593,582,830
금낭화로23길,834,414,420,92,101,112,91,182,256
금하로24길,3237,1613,1624,439,457,396,493,641,811
금호로1길,454,219,235,60,61,38,65,84,146
금호산2길,2570,1258,1312,286,344,371,381,430,758
길음로13길,1010,473,537,274,87,149,233,101,166
길음로7길,227,113,114,14,19,24,32,36,102
까치산로10길,2345,1117,1228,449,335,464,385,312,400
낙성대역10길,1914,1026,888,210,459,489,268,216,272
낙성대역3길,1678,805,873,192,449,355,232,170,280
난계로29길,1043,615,428,35,316,218,124,140,210
난계로30길,113,66,47,19,18,15,16,18,27
난곡로26길,2692,1356,1336,342,445,346,414,486,659
난곡로30길,2195,1116,1079,243,342,310,331,423,546
난곡로34길,2843,1457,1386,385,482,406,466,501,603
난곡로35길,3180,1594,1586,435,490,508,477,536,734
난곡로63길,1069,538,531,118,227,219,159,164,182
난곡로66길,462,228,234,47,120,94,76,52,73
난곡로78길,4346,2182,2164,522,926,782,633,612,871
난우길,2100,1041,1059,351,283,311,378,326,451
난향2길,262,137,125,16,41,22,26,50,107
난향길,2896,1497,1399,366,374,355,494,475,832
남부순환로124길,363,165,198,34,64,53,51,76,85
남부순환로144길,3281,1653,1628,389,601,664,474,508,645
남부순환로145길,839,430,409,84,194,180,110,95,176
남부순환로151길,2028,1030,998,238,425,404,306,299,356
남부순환로153길,1769,853,916,213,336,340,267,276,337
남부순환로159길,3199,1614,1585,396,660,548,503,502,590
남부순환로170길,5193,2545,2648,530,1129,1002,724,693,1115
남부순환로191길,1260,639,621,46,472,344,132,119,147
남부순환로208길,539,249,290,48,84,83,67,88,169
남부순환로230길,6325,3185,3140,686,1672,1263,847,705,1152
남부순환로234길,1662,881,781,185,436,351,222,189,279
남부순환로248길,1934,966,968,197,358,363,297,295,424
남부순환로272길,1148,542,606,64,261,316,146,144,217
남부순환로317길,1218,584,634,233,212,191,228,176,178
남부순환로323길,1367,658,709,222,241,211,212,215,266
남부순환로333길,585,284,301,77,93,147,88,71,109
남부순환로337가길,897,422,475,203,104,177,196,97,120
남부순환로350길,1055,489,566,88,215,236,153,154,209
남부순환로356길,2634,1277,1357,300,436,579,372,393,554
남부순환로40길,2737,1471,1266,346,340,306,487,542,716
남부순환로59길,791,404,387,119,108,116,130,152,166
남부순환로70길,2839,1438,1401,370,404,346,430,565,724
남부순환로95길,952,476,476,142,77,236,113,112,272
남부순환로97길,452,213,239,59,65,92,66,65,105
남현2길,3441,1687,1754,413,700,739,476,498,615
남현3길,2412,1095,1317,167,683,654,267,286,355
남현4길,1486,693,793,168,315,342,194,193,274
남현길,2301,1076,1225,345,519,430,275,266,466
노량진로6길,2485,1259,1226,224,427,353,377,437,667
노량진로8길,650,314,336,46,193,101,87,73,150
노원로1길,883,444,439,112,148,100,137,183,203
노해로17길,1466,723,743,204,206,204,254,242,356
노해로35길,1308,646,662,209,169,166,216,229,319
노해로41길,1844,887,957,316,237,282,291,287,431
노해로65길,54,50,4,2,3,5,13,17,14
노해로70길,1484,714,770,280,192,211,269,249,283
노해로8가길,1215,617,598,79,174,226,201,222,313
녹사평대로26길,908,423,485,75,141,187,124,159,222
녹사평대로40길,455,206,249,65,67,79,73,63,108
녹사평대로46가길,1317,657,660,211,195,230,202,168,311
녹사평대로46길,891,452,439,110,134,155,141,119,232
논현로5길,1730,851,879,288,276,308,302,283,273
논현로8길,3759,1835,1924,597,551,567,621,667,756
능동로19길,553,245,308,50,254,123,50,33,43
능동로4길,1347,671,676,272,190,230,243,198,214
다동길,4,1,3,1,0,0,1,1,1
다산로14길,506,240,266,34,127,105,66,73,101
다산로36길,1348,671,677,228,185,230,226,204,275
다산로42나길,786,389,397,100,119,100,126,135,206
다산로44길,698,341,357,38,142,119,109,112,178
다산로8길,994,488,506,134,167,146,152,155,240
답십리로30길,922,471,451,130,131,139,170,118,234
답십리로56길,1797,889,908,258,230,233,317,290,469
답십리로65길,2550,1294,1256,298,353,314,410,509,666
답십리로66길,3712,1896,1816,473,516,555,588,705,875
답십리로68길,3774,1892,1882,516,537,752,570,666,733
답십리로72길,755,390,365,123,116,146,125,130,115
당곡길,1446,712,734,141,265,268,210,215,347
당산로10길,770,410,360,66,154,190,90,123,147
당산로16길,1161,605,556,107,178,262,165,168,281
당산로18길,453,211,242,43,84,61,72,81,112
당산로28길,273,138,135,24,57,54,26,51,61
당산로31길,1037,515,522,147,165,251,137,158,179
당산로37길,962,451,511,83,107,133,136,159,344
당산로38길,1607,785,822,174,419,396,216,177,225
당산로44길,644,300,344,108,100,86,85,122,143
당산로48길,379,194,185,28,96,69,41,50,95
당산로52길,1551,772,779,136,335,313,204,241,322
대림로22길,1295,646,649,165,202,139,206,244,339
대림로29길,1479,787,692,140,199,243,239,277,381
대림로34길,1325,675,650,200,181,176,210,260,298
대림로44길,2146,1113,1033,334,312,285,374,415,426
대사관로30가길,1592,768,824,144,245,327,216,266,394
대사관로31길,112,58,54,16,21,26,22,15,12
대사관로34길,969,434,535,110,165,188,149,142,215
대학5길,1323,770,553,102,440,297,167,119,198
대학길,2893,1685,1208,250,677,586,470,387,523
대흥로21길,3330,1686,1644,307,731,530,458,507,797
덕릉로24길,674,336,338,67,110,111,106,102,178
덕릉로28길,1489,699,790,134,310,267,199,226,353
덕릉로30길,1877,879,998,192,311,280,280,308,506
덕릉로42길,1313,645,668,204,181,199,210,234,285
덕릉로54길,1327,684,643,176,170,157,241,227,356
덕릉로59아길,1524,753,771,327,192,222,275,245,263
덕릉로63가길,2306,1132,1174,389,314,344,393,425,441
덕릉로73길,1299,618,681,267,192,79,275,260,226
덕릉로83길,253,135,118,29,56,34,42,47,45
도곡로77길,1607,789,818,275,236,230,343,289,234
도당로15길,5100,2571,2529,680,722,646,858,918,1276
도림로108나길,1680,885,795,222,204,197,306,294,457
도림로113길,880,462,418,81,155,140,132,150,222
도림로12길,1658,821,837,226,210,227,275,285,435
도림로147길,674,378,296,30,100,107,74,117,246
도림로31길,1706,882,824,233,214,306,241,293,419
도림로38길,305,155,150,40,36,23,52,49,105
도림로41길,718,380,338,68,132,158,121,128,111
도림로53길,833,401,432,122,110,87,152,151,211
도봉로109길,2945,1438,1507,415,432,471,481,468,678
도봉로10다길,697,335,362,68,94,99,112,121,203
도봉로10라길,770,371,399,74,168,127,123,101,177
도봉로110길,2537,1253,1284,301,401,423,417,442,553
도봉로113길,1803,878,925,217,267,280,275,266,498
도봉로114길,2203,1049,1154,241,319,312,366,392,573
도봉로13가길,305,165,140,28,34,50,54,62,77
도봉로13길,1265,642,623,134,161,169,189,265,347
도봉로150길,915,436,479,152,124,133,135,171,200
도봉로152길,783,413,370,57,123,165,161,118,159
도봉로153길,3776,1905,1871,440,504,430,646,662,1094
도봉로156길,1159,622,537,128,143,144,171,235,338
도봉로165길,533,271,262,61,66,90,86,91,139
도봉로169나길,2904,1479,1425,289,341,393,428,591,862
도봉로18길,3342,1658,1684,391,480,418,558,601,894
도봉로20가길,924,461,463,96,125,129,131,179,264
도봉로28길,1739,909,830,237,206,230,308,307,451
도봉로29길,1946,974,972,267,266,249,303,375,486
도봉로30길,1107,562,545,128,139,176,175,199,290
도봉로35길,1360,677,683,208,185,231,231,235,270
도봉로38길,2877,1418,1459,438,421,423,489,442,664
도봉로46길,823,357,466,112,114,121,124,186,166
도봉로53길,4927,2389,2538,585,719,693,771,902,1257
도봉로57길,1481,732,749,170,225,188,247,271,380
도봉로73길,781,388,393,80,184,168,96,111,142
도봉로78길,7971,3791,4180,864,1318,1256,1150,1339,2044
도봉로81길,802,414,388,70,126,118,125,156,207
도봉로87길,729,378,351,30,88,133,140,147,191
도봉로8길,278,135,143,30,48,38,44,49,69
도봉산3길,4189,2128,2061,521,525,567,625,741,1210
도신로15길,1406,682,724,121,333,414,187,159,192
도신로19길,617,308,309,68,89,84,98,131,147
도신로29길,1403,701,702,264,165,187,293,227,267
도영로7길,1510,741,769,177,173,304,261,224,371
도화2길,1189,565,624,73,101,157,183,212,463
도화4길,1042,481,561,198,138,212,184,132,178
도화길,569,247,322,62,144,145,76,65,77
독립문로8길,2235,1071,1164,290,328,308,356,333,620
독막로19길,738,340,398,63,230,162,97,78,108
독막로22길,273,121,152,25,53,42,36,36,81
독막로32길,1137,567,570,139,163,204,176,175,280
독막로8길,521,230,291,48,117,154,70,63,69
독산로107길,1477,739,738,146,263,204,237,305,322
독산로108길,2881,1487,1394,334,472,470,450,576,579
독산로10길,2200,1104,1096,287,324,275,331,410,573
독산로22길,4026,2009,2017,530,501,540,654,713,1088
독산로28길,1365,703,662,179,182,189,223,252,340
독산로32길,1597,818,779,217,190,224,254,301,411
독산로35길,2803,1352,1451,372,379,349,441,507,755
독산로36길,3822,1900,1922,558,488,513,635,683,945
독산로38길,1627,832,795,227,220,256,267,310,347
독산로39길,2404,1149,1255,305,321,284,373,467,654
독산로40길,7471,3666,3805,1177,1071,1102,1172,1402,1547
독산로44길,2753,1371,1382,411,374,384,444,519,621
독산로64길,2297,1163,1134,339,330,286,397,476,469
독산로70길,2832,1467,1365,419,427,319,528,602,537
독산로74길,1115,556,559,131,190,139,172,228,255
독산로80길,3743,1842,1901,525,515,484,657,725,837
독산로85길,742,371,371,95,98,104,137,154,154
독산로87길,1716,837,879,183,239,206,282,381,425
독서당로51길,459,238,221,50,83,59,70,74,123
돈화문로4길,50,37,13,3,1,6,8,9,23
돌곶이로22나길,1837,929,908,229,262,236,288,331,491
돌곶이로23길,194,90,104,20,41,32,38,20,43
돌곶이로25길,1700,866,834,229,234,223,263,293,458
돌곶이로27길,2342,1186,1156,293,301,265,404,427,652
동광로12가길,166,85,81,22,16,25,34,14,55
동광로1길,2710,1253,1457,507,392,501,531,375,404
동광로3길,3908,1841,2067,722,569,654,771,612,580
동교로18길,148,76,72,22,21,30,24,16,35
동교로38길,839,389,450,72,167,207,109,99,185
동교로39길,686,317,369,97,109,153,95,95,137
동교로46길,192,100,92,18,38,58,28,18,32
동교로9길,1751,823,928,203,334,349,259,252,354
동남로81길,670,356,314,98,99,76,116,120,161
동남로8길,3759,1867,1892,521,607,736,602,639,654
동산로12길,1719,828,891,307,237,298,326,249,302
동산로13길,492,240,252,96,81,89,90,58,78
동산로19길,1805,914,891,282,270,389,361,238,265
동산로2길,287,142,145,43,34,64,56,42,48
동산로6길,1159,578,581,168,189,270,156,172,204
동소문로13가길,1224,555,669,172,256,211,193,145,247
동소문로13길,1339,626,713,238,261,185,205,196,254
동소문로13나길,1645,748,897,239,335,252,253,210,356
동소문로23길,1448,601,847,123,503,276,162,128,256
동소문로2길,642,310,332,59,92,76,94,113,208
동소문로5길,168,74,94,20,28,31,29,24,36
동소문로6길,581,287,294,56,84,70,87,100,184
동숭4나길,4644,2260,2384,686,745,866,769,695,883
동숭길,625,279,346,31,96,82,83,96,237
동일로101길,3036,1493,1543,478,424,443,515,573,603
동일로109길,3878,1969,1909,528,564,596,652,700,838
동일로123길,4464,2327,2137,498,568,590,706,958,1144
동일로149길,4025,2020,2005,620,549,607,633,714,902
동일로151길,3269,1658,1611,479,458,583,495,569,685
동일로157길,2900,1456,1444,355,392,468,471,484,730
동일로173가길,2488,1275,1213,331,424,453,335,410,535
동일로178길,4403,2132,2271,577,877,786,632,698,833
동일로183길,1651,867,784,238,253,292,239,268,361
동일로184길,2315,1238,1077,273,602,372,288,361,419
동일로186길,2756,1400,1356,284,651,431,342,457,591
동일로192길,745,376,369,97,203,91,92,117,145
동일로193길,1025,505,520,157,144,161,159,171,233
동일로195길,1556,744,812,288,235,216,251,265,301
동일로203가길,1298,614,684,291,213,203,300,212,79
동일로207길,1085,498,587,190,142,128,181,148,296
동일로208길,952,471,481,189,107,173,192,114,177
동일로217길,67,41,26,6,12,5,17,13,14
동일로231길,1043,509,534,197,184,127,157,200,178
동일로239길,2198,1121,1077,346,331,266,385,373,497
동일로241가길,1210,603,607,151,216,179,170,218,276
동일로242가길,550,252,298,70,98,91,86,82,123
동일로242길,937,463,474,156,134,144,112,163,228
동일로242다길,530,270,260,76,79,53,88,94,140
동일로243길,57,32,25,4,11,12,10,11,9
동일로72길,2328,1127,1201,358,355,374,424,392,425
동일로99길,2633,1339,1294,440,333,390,475,440,555
동작대로7길,1545,751,794,92,361,324,179,247,342
동호로11길,1988,952,1036,243,311,304,348,274,508
동호로14길,735,328,407,92,140,185,106,91,121
동호로15길,2361,1104,1257,290,324,336,425,351,635
동호로25길,1408,756,652,169,438,249,169,164,219
두산로13길,256,161,95,16,48,62,41,45,44
두산로5길,1347,799,548,105,305,436,195,131,175
두텁바위로15길,342,178,164,56,43,38,68,56,81
두텁바위로58길,1830,889,941,255,265,303,315,272,420
둘레15길,872,467,405,110,116,147,143,168,188
둘레길,5733,3002,2731,763,886,796,976,1162,1150
등촌로39길,3309,1685,1624,546,513,564,518,549,619
등촌로55길,2023,985,1038,282,366,582,282,244,267
등촌로5가길,3636,1723,1913,473,532,691,544,600,796
디지털로27길,3780,1895,1885,458,439,525,606,713,1039
디지털로32길,297,156,141,23,51,57,59,49,58
디지털로32나길,1058,537,521,73,248,385,164,109,79
디지털로38길,780,385,395,62,137,153,81,121,226
디지털로54길,1250,602,648,166,130,157,200,228,369
디지털로57길,1501,728,773,190,178,158,240,288,447
뚝섬로27길,3837,1911,1926,382,616,669,545,720,905
뚝섬로56길,2461,1205,1256,471,348,420,433,360,429
마른내로12길,431,219,212,21,115,123,55,57,60
마방로4길,2272,1139,1133,359,333,504,387,321,368
마장로35길,522,266,256,92,70,71,74,98,117
마장로35나길,273,133,140,54,45,35,54,44,41
마장로9길,1066,575,491,83,180,208,134,182,279
마천로51길,4121,2093,2028,545,465,529,651,806,1125
마천로57길,1985,1019,966,304,227,292,344,321,497
마천로7길,1290,627,663,230,220,175,186,256,223
마포대로12길,296,139,157,29,33,60,42,36,96
마포대로14길,896,447,449,101,123,173,168,128,203
마포대로16길,633,328,305,81,93,95,106,101,157
마포대로4길,851,413,438,120,130,158,133,123,187
만리재로24길,1636,822,814,214,245,251,281,305,340
만리재로35길,996,528,468,132,101,158,150,164,291
만리재옛길,4048,1947,2101,423,570,612,690,670,1083
망우로10길,1238,628,610,160,370,202,134,137,235
망우로14길,2028,1048,980,214,470,305,281,289,469
망우로16길,1923,1007,916,218,671,285,213,223,313
망우로18다길,970,504,466,82,352,115,102,115,204
망우로32길,136,65,71,8,45,32,16,16,19
매봉길,5529,2658,2871,883,747,1451,861,808,779
면목로27길,2080,1061,1019,306,304,289,354,381,446
면목로33길,7624,3806,3818,1170,1070,1114,1306,1345,1619
면목로35길,1237,621,616,162,148,173,212,207,335
면목로48길,4809,2308,2501,574,805,773,741,841,1075
면목로54길,3907,1926,1981,478,619,585,631,737,857
면목로74길,429,218,211,26,59,64,62,83,135
면목로91길,1645,776,869,138,338,332,207,271,359
면목로92길,848,424,424,82,138,186,112,138,192
면목천로23길,4107,2120,1987,512,608,621,639,780,947
명동길,26,10,16,1,4,4,8,3,6
명륜길,1336,687,649,127,384,187,150,165,323
명지대길,1438,699,739,164,357,196,185,223,313
목동남로4길,1837,903,934,292,279,212,305,334,415
목동중앙남로10길,1217,603,614,220,212,176,215,204,190
목동중앙남로13길,1238,618,620,203,196,254,189,192,204
목동중앙남로4길,750,364,386,156,93,97,143,127,134
목동중앙본로7길,2021,995,1026,360,320,330,324,334,353
목동중앙북로7길,178,75,103,12,33,47,18,24,44
목동중앙북로8라길,1636,758,878,232,241,304,244,261,354
목동중앙서로7길,2979,1501,1478,517,482,432,534,528,486
무수막길,3181,1563,1618,432,420,456,508,518,847
무학로14길,1483,733,750,196,229,220,247,262,329
무학로30길,1151,581,570,149,196,187,188,158,273
무학로43길,1015,549,466,133,163,121,163,192,243
무학봉15길,1494,790,704,142,190,194,238,289,441
무학봉길,2756,1333,1423,295,443,372,409,510,727
문성로30길,1128,567,561,136,216,215,177,137,247
미성길,1769,875,894,261,268,259,279,297,405
바람드리길,2866,1397,1469,315,343,456,482,473,797
바우뫼로37길,540,285,255,53,79,138,83,74,113
바우뫼로39길,5231,2501,2730,655,837,1205,780,711,1043
반포대로12길,16,7,9,4,2,1,5,1,3
반포대로19길,277,138,139,38,47,45,48,52,47
반포대로21길,1313,663,650,264,192,202,236,213,206
반포대로22길,278,136,142,26,38,40,59,45,70
반포대로9길,3124,1500,1624,544,495,467,533,451,634
방배로15길,2660,1235,1425,409,381,545,469,365,491
방배로23길,1881,879,1002,294,299,373,334,232,349
방배로31길,5570,2574,2996,889,792,1080,944,778,1087
방배로42길,614,283,331,125,87,98,108,91,105
방배로6길,372,183,189,45,65,62,54,64,82
방배천로4안길,1104,519,585,171,198,209,166,160,200
방울내로7길,1636,791,845,218,247,342,278,235,316
방학로6길,5275,2599,2676,664,755,665,824,1002,1365
방화동로5길,1904,918,986,154,307,281,270,336,556
백범로16길,621,319,302,62,81,97,94,106,181
백범로25길,2286,1072,1214,365,364,346,359,361,491
백범로26길,61,30,31,4,6,8,12,5,26
백범로77길,1843,898,945,250,273,358,303,254,405
백범로87길,157,98,59,10,14,15,17,33,68
백범로90다길,1505,720,785,260,212,439,241,181,172
백범로90라길,1024,497,527,164,141,294,154,122,149
백석동길,1733,847,886,251,255,256,317,290,364
백제고분로12길,4580,2141,2439,731,720,1040,810,604,675
백제고분로18길,4625,2179,2446,725,770,956,747,700,727
백제고분로19길,5464,2555,2909,739,928,1236,875,798,888
백제고분로21길,2279,1102,1177,256,360,582,369,358,354
백제고분로27길,5346,2491,2855,765,846,1165,910,765,895
백제고분로31길,4292,1982,2310,636,656,980,755,584,681
백제고분로32길,19310,9263,10047,3036,2982,4210,3264,2766,3052
백제고분로34길,5871,2890,2981,868,906,1268,981,852,996
백제고분로39길,3368,1558,1810,450,588,796,489,470,575
백제고분로40길,6775,3233,3542,1037,1013,1336,1125,1022,1242
백제고분로41길,5897,2754,3143,726,1041,1465,834,813,1018
백제고분로42길,3299,1567,1732,391,542,745,550,480,591
백제고분로45길,3728,1809,1919,504,681,861,549,535,598
백제고분로46길,3573,1715,1858,567,576,760,575,521,574
백제고분로50길,5763,2835,2928,836,963,1094,887,908,1075
범안로17길,1856,970,886,241,315,380,312,275,333
법원단지5길,2072,1021,1051,337,293,309,360,371,402
법원단지길,5461,2760,2701,865,857,752,893,923,1171
보국문로11길,529,270,259,62,84,72,81,77,153
보국문로16길,1167,561,606,169,162,198,182,187,269
보국문로18길,1226,591,635,155,181,191,196,209,294
보국문로8길,3388,1664,1724,466,524,445,537,565,851
보라매로2길,672,332,340,74,141,139,94,81,143
보문로13다길,2144,1037,1107,316,326,364,401,318,419
보문로19길,857,447,410,113,139,130,143,133,199
보문로23길,1591,778,813,190,295,271,246,245,344
보문로29다길,630,314,316,113,88,93,128,80,128
보문로30가길,1411,595,816,131,430,257,183,171,239
보문로34길,740,246,494,56,301,173,76,51,83
보문로34나길,2590,1058,1532,237,689,427,361,293,583
보문로37길,231,104,127,20,49,54,42,25,41
보문로3길,334,193,141,17,30,18,57,71,141
복은길,3451,1807,1644,390,736,691,479,476,679
봉우재로14길,650,336,314,97,76,79,107,127,164
봉우재로28길,1412,707,705,203,190,254,218,242,305
봉우재로33길,1536,772,764,152,233,262,227,287,375
봉우재로70길,2674,1322,1352,354,352,366,434,508,660
봉천로13길,2390,1203,1187,322,435,397,342,343,551
봉천로23길,2328,1131,1197,288,438,439,336,318,509
봉천로23나길,1564,786,778,198,302,348,202,203,311
봉천로30길,171,92,79,11,25,21,28,22,64
봉천로31길,776,379,397,81,169,154,115,88,169
봉천로33길,1052,530,522,134,192,220,160,121,225
봉천로6길,3353,1690,1663,248,831,788,437,392,657
봉화산로30길,5307,2669,2638,733,825,906,758,951,1134
봉화산로4길,3804,1987,1817,389,508,569,607,768,963
봉화산로56길,2920,1450,1470,514,421,435,465,509,576
부일로15길,690,343,347,108,90,101,124,95,172
북아현로12길,1172,586,586,145,165,146,181,211,324
북아현로14길,1436,701,735,191,221,183,224,238,379
북촌로5가길,490,219,271,69,66,54,66,81,154
북촌로5나길,968,470,498,143,140,138,155,158,234
북촌로6길,263,119,144,38,29,36,48,45,67
불광로18길,830,403,427,117,96,91,127,154,245
불광로2길,1852,906,946,204,169,206,338,345,590
사가정로27길,1464,728,736,218,228,214,190,299,315
사가정로51길,2842,1417,1425,300,358,484,490,484,726
사근동11길,2088,1113,975,272,435,275,316,280,510
사근동8가길,1041,576,465,110,394,131,111,107,188
사근동8길,617,340,277,65,227,63,70,69,123
사근동길,2482,1305,1177,301,749,342,295,308,487
사당로14가길,438,211,227,60,70,79,62,64,103
사당로16길,3519,1701,1818,397,496,614,552,566,894
사당로17길,1847,893,954,240,309,359,231,269,439
사임당로12길,681,339,342,97,117,166,123,68,110
사임당로1길,493,245,248,62,83,93,72,59,124
사직로12길,123,58,65,10,9,14,17,24,49
사직로8길,172,93,79,27,26,20,33,38,28
사평대로22길,2101,988,1113,423,264,308,373,315,418
사평대로28길,1134,514,620,182,159,170,194,179,250
사평대로2길,1396,647,749,221,171,183,273,205,343
사평대로57길,407,172,235,39,88,115,62,39,64
살곶이8길,686,392,294,63,332,78,53,54,106
삼각산로22길,527,246,281,83,92,64,91,96,101
삼선교로10길,2004,956,1048,253,371,334,277,315,454
삼선교로14길,3807,1861,1946,496,703,568,575,588,877
삼선교로23길,2027,968,1059,222,449,303,319,303,431
삼선교로4길,2099,1071,1028,228,327,281,336,361,566
삼성로100길,272,133,139,22,40,59,43,37,71
삼성로146길,113,47,66,12,32,22,16,10,21
삼성로64길,1946,975,971,421,330,172,427,335,261
삼양로112길,296,147,149,48,42,43,51,46,66
삼양로139길,2356,1137,1219,288,246,275,389,363,795
삼양로144길,456,217,239,86,70,62,79,56,103
삼양로173길,1305,629,676,166,181,164,183,230,381
삼양로19길,1659,769,890,323,180,212,306,267,371
삼양로20길,2259,1137,1122,265,338,236,345,456,619
삼양로24길,1978,998,980,187,199,245,304,371,672
삼양로27길,623,289,334,118,63,91,120,98,133
삼양로32가길,247,120,127,27,31,28,37,48,76
삼양로38길,1688,859,829,206,226,207,268,309,472
삼양로73길,928,464,464,80,80,92,157,163,356
삼양로74길,1079,529,550,135,131,132,149,196,336
삼양로77가길,1597,798,799,214,202,219,240,282,440
삼양로8길,934,453,481,100,124,115,136,172,287
삼양로91길,929,449,480,129,129,103,144,151,273
삼양로93길,1061,522,539,166,133,129,164,189,280
삼양로99길,478,232,246,93,72,65,83,73,92
삼일대로32가길,897,501,396,79,128,160,166,157,207
삼일대로32길,1084,610,474,107,146,178,202,184,267
삼일대로4길,5,1,4,0,0,0,1,0,4
삼청로5길,354,164,190,45,43,47,43,64,112
상계로12길,1809,926,883,183,278,245,304,314,485
상계로37길,752,374,378,89,108,92,124,146,193
상계로9가길,1802,911,891,251,231,268,273,306,473
상도로15길,3070,1479,1591,256,675,707,415,402,615
상봉로11길,1471,724,747,201,190,207,219,282,372
상원10길,1147,603,544,118,206,213,191,205,214
상원길,1109,539,570,179,205,224,187,156,158
상일로5길,1443,733,710,247,235,192,219,288,262
새말로16길,2307,1137,1170,293,400,505,313,350,446
새창로33길,865,457,408,88,114,143,136,129,255
서강대길,1015,502,513,207,142,179,214,150,123
서강로11길,676,339,337,53,185,130,91,81,136
서강로20길,793,426,367,60,247,139,102,103,142
서달로14길,454,215,239,40,77,69,52,68,148
서달로15길,266,141,125,32,34,48,37,42,73
서래로5길,2189,1039,1150,402,309,364,400,340,374
서림3길,3334,2150,1184,197,1142,861,442,287,405
서순라길,206,108,98,17,22,27,36,31,73
서오릉로13길,4244,1974,2270,680,608,675,733,652,896
서오릉로21길,14813,7714,7099,2389,1831,2103,2527,2468,3495
서오릉로7길,955,466,489,138,121,169,152,144,231
서오릉로8길,2536,1227,1309,320,352,373,411,425,655
서운로11길,1058,534,524,164,160,208,204,152,170
서울숲2길,2352,1174,1178,287,385,383,376,399,522
서울시립대로27길,720,374,346,66,127,95,97,115,220
서울시립대로29길,1340,692,648,152,361,208,146,179,294
서울시립대로2길,1242,616,626,192,149,213,216,183,289
서울시립대로5길,548,301,247,44,70,55,84,99,196
서초대로19길,6020,2747,3273,1015,901,1123,1062,835,1084
서초대로1길,993,448,545,260,116,136,211,137,133
서초대로23길,4468,2091,2377,705,645,882,749,638,849
서초대로25길,1115,529,586,178,176,222,168,159,212
서초대로26길,1437,670,767,198,244,351,214,173,257
서초대로33길,3893,1852,2041,725,549,630,645,619,725
서초대로34길,799,387,412,125,92,137,129,112,204
서초대로38길,1546,751,795,199,267,241,231,283,325
서초대로4길,1319,623,696,208,192,225,221,199,274
서초대로54길,1451,699,752,198,213,231,226,254,329
서초대로65길,870,423,447,248,96,89,216,125,96
서초중앙로31길,1166,576,590,266,149,143,238,184,186
서초중앙로33길,332,154,178,69,47,53,53,50,60
서해안로24길,653,307,346,72,66,85,109,145,176
석계로13길,1688,894,794,298,352,228,270,202,338
석계로18길,82,50,32,12,15,15,6,12,22
석계로7길,953,508,445,97,136,129,144,160,287
석촌호수로18길,6578,3124,3454,859,1104,1605,1012,896,1102
선릉로130길,991,487,504,262,123,113,234,130,129
선릉로6길,397,189,208,78,48,62,66,57,86
선유로33길,782,387,395,153,94,177,121,88,149
선유로43가길,169,85,84,36,24,11,34,19,45
선유로9나길,893,459,434,157,136,203,150,98,149
선유서로25길,1391,771,620,127,248,293,233,210,280
성균관로9길,310,144,166,30,79,44,40,39,78
성대로1길,375,210,165,35,65,79,50,67,79
성덕정11길,782,405,377,114,117,96,137,147,171
성덕정19길,1452,760,692,186,206,216,202,295,347
성덕정3길,990,514,476,135,166,125,160,187,217
성덕정길,6655,3496,3159,839,1029,939,1085,1326,1437
성미산로1길,2061,1004,1057,320,313,382,394,267,385
성미산로29길,973,468,505,85,144,140,164,157,283
성북로14가길,751,347,404,133,94,119,160,99,146
성북로15길,372,165,207,59,52,40,81,50,90
성북로18길,557,274,283,97,77,77,117,77,112
성북로31길,455,219,236,52,52,47,79,86,139
성북로8길,1263,607,656,181,202,199,223,199,259
성수이로7가길,467,257,210,34,140,111,54,64,64
성수일로1길,299,146,153,56,41,67,50,35,50
성수일로4길,1175,621,554,107,170,180,176,239,303
성안로3길,3655,1794,1861,573,527,694,657,529,675
성암로3길,902,449,453,114,153,158,145,129,203
성지3길,1322,625,697,125,243,295,185,178,296
성지길,1508,725,783,156,241,332,223,224,332
세검정로1길,1193,565,628,191,143,139,193,194,333
세검정로3길,1226,614,612,148,180,139,187,216,356
세무서7길,553,244,309,61,70,74,90,77,181
세무서길,2695,1277,1418,363,386,317,414,437,778
세종대로2가길,87,58,29,2,5,7,16,20,37
소공로3길,536,261,275,61,66,73,96,77,163
소공로6길,89,40,49,16,7,15,10,16,25
소월로20길,1296,652,644,143,181,208,197,218,349
소월로2길,375,196,179,42,50,67,55,71,90
소월로38가길,945,398,547,49,76,124,154,177,365
솔매로17길,1157,607,550,198,153,177,194,189,246
솔매로36길,2386,1145,1241,278,351,353,392,417,595
솔매로43길,3470,1669,1801,420,524,508,552,607,859
솔매로44길,4543,2181,2362,564,653,714,768,736,1108
솔매로46길,3710,1847,1863,453,486,548,587,650,986
솔매로50길,2010,969,1041,273,314,304,299,357,463
솔샘로18길,1197,588,609,163,179,169,171,188,327
솔샘로1길,514,276,238,36,112,40,83,83,160
솔샘로47길,1016,490,526,115,153,103,152,205,288
솔샘로48길,206,96,110,22,23,13,42,34,72
솔샘로4길,1300,640,660,176,206,196,170,196,356
솔샘로64길,1015,521,494,107,151,129,155,192,281
솔샘로65길,7159,3563,3596,934,1039,1052,1098,1320,1716
솔샘로67길,1406,732,674,139,198,219,211,266,373
솔샘로68길,419,206,213,34,63,50,57,86,129
송월길,3859,1810,2049,772,474,699,702,570,642
송파대로38길,749,358,391,115,112,154,118,109,141
수색로14길,466,246,220,41,63,49,62,99,152
수색로2길,9032,4357,4675,2115,1050,1444,1708,1223,1492
수유로23길,9702,4819,4883,1190,1472,1600,1497,1663,2280
수유로4길,2797,1383,1414,314,520,505,429,431,598
숭문16길,839,423,416,75,191,95,141,143,194
숭문길,2555,1235,1320,298,394,375,400,410,678
숭인동길,1091,545,546,134,139,143,181,171,323
승방길,2271,1094,1177,179,642,612,235,288,315
시흥대로102길,1120,596,524,114,182,220,137,223,244
시흥대로120길,1953,970,983,227,282,254,313,395,482
시흥대로122길,444,233,211,55,61,52,78,100,98
시흥대로128길,258,135,123,26,27,60,43,43,59
시흥대로136길,898,464,434,116,109,133,143,154,243
시흥대로138길,404,212,192,48,39,67,54,86,110
시흥대로141길,1138,625,513,89,231,197,168,225,228
시흥대로149길,790,450,340,68,137,158,104,169,154
시흥대로150길,2612,1338,1274,338,365,318,423,540,628
시흥대로151길,2222,1176,1046,188,426,430,308,429,441
시흥대로152길,1726,854,872,227,270,302,269,278,380
시흥대로153길,2763,1589,1174,151,680,769,388,375,400
시흥대로160길,599,329,270,51,159,141,85,70,93
시흥대로28길,5233,2606,2627,846,697,752,836,871,1231
시흥대로40마길,6146,3100,3046,816,838,739,984,1194,1575
시흥대로47길,1877,956,921,345,288,356,285,304,299
시흥대로50길,763,371,392,98,125,114,128,128,170
시흥대로68길,2215,1078,1137,270,346,317,320,406,556
시흥대로71길,110,54,56,5,16,15,17,18,39
시흥대로72길,3670,1839,1831,500,539,502,550,692,887
시흥대로88길,3110,1569,1541,442,446,472,464,568,718
시흥대로94길,5336,2680,2656,697,833,824,823,1051,1108
시흥대로96길,1257,662,595,158,193,178,214,253,261
시흥대로98길,1467,767,700,219,217,216,234,283,298
신길로23나길,289,151,138,44,42,26,46,56,75
신길로34길,103,59,44,3,17,16,14,23,30
신길로38길,907,478,429,88,152,106,151,142,268
신길로39길,1824,924,900,215,202,187,322,356,542
신길로40길,628,312,316,78,81,80,95,109,185
신길로41길,3456,1730,1726,448,488,402,602,627,889
신길로42가길,4783,2392,2391,573,626,565,780,926,1313
신길로60마길,1627,837,790,170,183,213,267,290,504
신길로8길,380,182,198,45,45,57,63,52,118
신내로17길,428,224,204,51,75,107,77,64,54
신대방1가길,1605,793,812,200,305,299,243,234,324
신도림로11길,2075,1078,997,310,281,288,324,336,536
신림동5가길,1623,783,840,78,676,458,152,107,152
신림동길,4152,2079,2073,186,1463,1143,511,354,495
신림로11길,3457,2025,1432,278,950,769,519,419,522
신림로14길,570,334,236,36,171,137,65,53,108
신림로17길,1962,1205,757,127,578,437,345,197,278
신림로23길,1494,920,574,92,405,340,253,174,230
신림로28길,2073,1151,922,188,485,460,295,268,377
신림로30길,1465,849,616,117,410,376,202,164,196
신림로32길,571,281,290,61,146,113,72,79,100
신림로38길,1416,738,678,130,339,290,204,177,276
신림로3가길,1517,881,636,154,450,280,201,158,274
신림로48길,1631,842,789,166,373,333,201,239,319
신림로58길,3084,1512,1572,246,799,669,403,340,627
신림로64길,1198,636,562,40,449,337,139,106,127
신림로65길,1711,800,911,76,671,475,169,150,170
신림로73길,7013,3513,3500,588,1749,1724,945,791,1216
신목로2길,1281,626,655,225,183,151,246,247,229
신목로4길,2189,1074,1115,424,270,272,402,361,460
신목로5길,2225,1114,1111,535,310,261,471,370,278
신반포로15길,786,366,420,139,62,74,186,111,214
신반포로45길,2531,1195,1336,307,416,552,437,332,487
신원로3길,4307,2151,2156,421,896,735,631,633,991
신원로4길,593,318,275,63,112,134,82,89,113
신월로15길,887,445,442,159,109,123,140,172,184
신월로16길,167,95,72,18,22,15,26,38,48
신이문로24길,456,232,224,55,61,55,85,72,128
신정중앙로23길,1366,617,749,159,204,274,199,182,348
신촌로12길,572,259,313,19,193,141,59,66,94
신촌로1길,2093,994,1099,189,629,479,269,216,311
신촌로24길,2113,984,1129,140,416,369,334,325,529
신촌로30길,1915,964,951,170,347,253,260,344,541
신촌로37안길,3131,1560,1571,278,505,451,476,595,826
신촌로3길,799,379,420,58,224,211,84,97,125
신촌로4길,553,244,309,62,123,112,84,68,104
신촌로9길,1686,808,878,117,653,322,155,155,284
신풍로8길,224,115,109,22,21,34,37,38,72
신흥로20길,1576,781,795,206,215,243,246,251,415
신흥안길,127,67,60,14,25,14,18,23,33
쑥고개로11길,854,411,443,106,168,146,122,118,194
아리랑로19길,1544,744,800,262,189,212,271,229,381
아리랑로5길,1121,565,556,201,139,161,208,161,251
아차산로51길,1835,877,958,231,374,399,265,278,288
아차산로70길,438,207,231,138,33,82,103,45,37
아차산로76길,347,167,180,37,67,73,45,59,66
아차산로7가길,268,149,119,25,49,68,34,47,45
아차산로7길,842,454,388,100,173,173,117,146,133
안암로5길,655,319,336,74,107,109,108,110,147
안암로6길,958,550,408,83,240,190,114,119,212
안암로9가길,883,513,370,77,311,165,98,108,124
안암로9나길,735,378,357,101,143,129,120,104,138
압구정로29길,968,459,509,226,92,126,212,94,218
압구정로4길,716,316,400,107,124,152,134,84,115
약령서길,902,451,451,87,189,144,105,128,249
양녕로1길,1082,544,538,104,220,217,160,135,246
양녕로2길,2656,1316,1340,268,579,533,346,354,576
양산로19길,774,380,394,58,174,179,103,90,170
양산로23길,462,217,245,36,86,105,44,79,112
양재대로103길,1979,1006,973,226,298,503,293,295,364
양재대로124길,3197,1600,1597,485,461,568,478,582,623
양재대로128길,1704,828,876,203,278,291,235,294,403
양재대로85길,4255,2160,2095,699,574,706,718,724,834
양재천로19길,215,108,107,15,37,61,23,36,43
양천로14길,3681,1803,1878,631,518,538,605,623,766
양천로49길,1121,584,537,154,218,231,144,164,210
양천로57길,1305,571,734,54,313,381,149,177,231
양천로69길,2001,978,1023,502,236,301,410,281,271
양평로17길,2116,1048,1068,338,333,424,347,298,376
양평로18길,2751,1401,1350,249,635,680,343,376,468
양평로19길,630,318,312,98,116,170,101,61,84
양평로20길,1761,927,834,168,345,404,223,256,365
양평로22길,958,470,488,85,233,255,118,112,155
양평로24길,1056,527,529,137,219,281,144,128,147
양화로19길,252,116,136,26,50,42,37,39,58
양화로23길,356,165,191,35,60,91,49,38,83
양화로7길,1198,527,671,125,206,270,202,152,243
어울마당로1길,378,168,210,36,81,102,52,52,55
언남11길,599,304,295,85,91,113,109,106,95
언주로108길,377,154,223,30,72,137,65,24,49
언주로125길,558,250,308,57,106,144,91,57,103
언주로30길,4798,2173,2625,906,702,618,777,884,911
여의대방로13길,433,207,226,34,107,108,61,64,59
여의대방로24가길,929,436,493,121,201,244,136,108,119
여의대방로36길,2944,1443,1501,481,528,410,566,427,532
여의대방로43가길,493,242,251,58,85,92,89,74,95
여의대방로55길,671,349,322,133,159,159,122,51,47
역말로9길,4859,2319,2540,688,645,746,821,798,1161
역삼로78길,1866,896,970,333,312,306,394,276,245
연남로5길,3805,1744,2061,412,823,907,567,420,676
연대동문길,989,444,545,102,336,184,110,87,170
연무장3길,593,325,268,90,78,101,89,112,123
연무장5가길,403,239,164,28,67,59,73,92,84
연무장길,3085,1609,1476,404,485,445,459,596,696
연서로13길,3284,1570,1714,524,491,504,568,543,654
연서로16길,3289,1551,1738,523,384,483,564,555,780
연서로17길,2215,1069,1146,323,318,333,380,385,476
연서로19길,3612,1728,1884,579,524,571,629,583,726
연서로20길,7196,3388,3808,1125,1003,1146,1293,1102,1527
연서로21길,4323,2051,2272,747,578,698,799,634,867
연서로27길,4390,2072,2318,633,611,688,784,701,973
연서로28길,3774,1772,2002,430,734,701,564,550,795
연서로34길,2513,1192,1321,346,349,369,385,430,634
연서로3길,4186,1973,2213,732,590,743,706,614,801
연서로5길,4570,2174,2396,801,630,764,808,693,874
연서로6길,5818,2790,3028,936,799,1010,1016,851,1206
연서로9길,6143,2929,3214,1107,832,995,1088,933,1188
연세로2길,348,129,219,24,108,78,47,34,57
연세로4길,355,167,188,25,129,52,43,45,61
연희로11가길,484,215,269,55,69,91,55,83,131
연희로15길,1850,858,992,256,299,282,287,270,456
연희로25길,987,452,535,171,166,179,161,134,176
연희로41가길,1679,813,866,234,231,196,276,281,461
연희로41길,2855,1382,1473,409,401,372,468,479,726
연희로8길,1946,1052,894,161,754,353,192,182,304
영등포로13길,855,444,411,57,96,106,120,180,296
영등포로18길,197,99,98,14,22,43,23,38,57
영등포로25길,2026,1044,982,197,342,406,267,329,485
영등포로27길,1580,879,701,135,249,358,225,239,374
영등포로5길,838,461,377,97,103,122,132,159,225
영등포로62길,1094,583,511,119,195,243,168,155,214
영등포로64길,3014,1474,1540,515,436,480,480,492,611
영등포로72길,1834,933,901,193,285,282,291,304,479
영등포로80길,5872,2928,2944,588,911,914,881,1027,1551
영등포로84길,2333,1194,1139,210,443,398,362,404,516
영신로17길,408,220,188,28,83,75,57,67,98
영신로19길,285,167,118,11,57,54,46,48,69
영신로57길,624,292,332,88,169,119,96,70,82
영중로42길,20,8,12,0,6,6,1,2,5
오금로11길,1326,650,676,143,196,365,244,163,215
오금로31길,1373,688,685,317,216,171,268,232,169
오금로32길,1078,527,551,231,168,130,177,205,167
오금로35길,1217,610,607,155,191,224,159,207,281
오금로36길,2223,1149,1074,311,383,395,347,367,420
오금로46길,3047,1489,1558,586,472,449,517,485,538
오류로8길,2871,1445,1426,390,362,418,402,483,816
오목로54길,4766,2320,2446,943,663,569,851,837,903
오패산로13길,383,196,187,40,43,43,61,65,131
오패산로19길,638,331,307,55,84,78,93,128,200
오패산로30길,1557,762,795,226,191,223,231,262,424
오패산로31길,1434,691,743,167,190,228,225,219,405
오패산로3길,2233,1084,1149,313,274,319,368,363,596
오패산로67길,1977,969,1008,184,323,379,356,310,425
오현로31길,3528,1781,1747,549,473,491,600,601,814
오현로32길,465,235,230,95,59,58,87,67,99
옥인6길,1283,597,686,254,173,184,247,192,233
올림픽로32길,4459,2115,2344,526,690,1029,679,735,800
올림픽로35길,1815,896,919,307,237,250,274,329,418
올림픽로4길,289,126,163,32,41,38,42,49,87
올림픽로62길,1186,582,604,87,182,203,187,217,310
올림픽로92길,6767,3360,3407,990,878,1216,1070,1130,1483
올림픽로98길,7211,3615,3596,1009,978,1249,1172,1245,1558
와우산로29길,823,395,428,78,206,189,128,76,146
와우산로29나길,495,233,262,39,186,109,55,42,64
와우산로30길,1229,625,604,112,376,253,172,150,166
와우산로3길,1344,649,695,117,282,341,201,156,247
왕산로22길,2050,1032,1018,159,491,471,313,281,335
왕산로30길,1295,648,647,101,183,190,162,225,434
왕산로32길,819,410,409,80,149,122,108,121,239
왕산로3길,748,417,331,78,126,134,115,116,179
왕산로45길,1744,922,822,149,180,237,275,344,559
왕십리로14길,722,368,354,72,139,139,106,120,146
왕십리로26길,3174,1610,1564,394,549,483,509,532,707
왕십리로30길,3152,1589,1563,402,538,507,499,524,682
왕십리로33길,1001,494,507,93,176,166,179,150,237
왕십리로5길,1287,622,665,161,187,217,232,207,283
왕십리로6길,1661,869,792,251,253,268,299,274,316
왕십리로8길,553,287,266,55,102,104,86,91,115
용답중앙11다길,412,194,218,29,92,70,47,81,93
용답중앙13길,1405,672,733,153,270,242,201,244,295
용답중앙길,6940,3512,3428,859,1038,1050,1143,1235,1615
용마산로115길,2321,1179,1142,274,328,406,354,411,548
용마산로117길,832,438,394,103,119,127,109,149,225
용마산로45길,2005,988,1017,225,256,289,299,307,629
우사단로10길,2983,1575,1408,285,443,583,485,448,739
우사단로2길,1382,659,723,162,229,211,244,204,332
우이천로4라길,8452,4169,4283,1460,1090,1152,1387,1365,1998
원효로19길,910,453,457,130,164,172,144,136,164
원효로35길,1352,632,720,202,189,195,236,188,342
원효로41길,895,420,475,129,102,132,163,132,237
원효로53길,1167,610,557,132,155,193,189,177,321
원효로71길,778,372,406,87,129,132,116,116,198
원효로89길,584,297,287,49,105,93,93,107,137
월계로37길,1631,784,847,278,227,204,262,297,363
월계로7나길,3314,1602,1712,364,514,473,552,540,871
월곡로5길,2650,1273,1377,242,294,296,350,452,1016
월드컵로10길,1926,851,1075,243,307,478,332,225,341
월드컵로14길,3466,1561,1905,529,589,690,543,572,543
월드컵로23길,6345,3008,3337,694,1083,1269,1035,908,1356
월드컵로25길,2194,1057,1137,344,306,405,371,308,460
월드컵로29길,5632,2662,2970,900,791,987,976,781,1197
월드컵로31길,3712,1801,1911,614,559,720,622,489,708
월드컵로32길,1184,582,602,155,188,222,203,167,249
월드컵로36길,1539,601,938,165,361,412,264,133,204
월드컵로3길,3236,1494,1742,472,540,741,524,378,581
월드컵로7길,5712,2608,3104,784,1050,1311,893,692,982
월드컵북로16길,6022,2890,3132,819,927,1149,1055,867,1205
월드컵북로30길,3840,1873,1967,623,562,754,659,527,715
월드컵북로48길,2033,985,1048,276,428,418,290,258,363
월드컵북로4길,686,311,375,85,128,163,103,72,135
월드컵북로6길,2618,1211,1407,318,486,615,412,274,513
월드컵북로7길,3117,1481,1636,408,532,631,546,427,573
위례성대로18길,4063,1972,2091,696,596,709,671,669,722
위례성대로20길,519,265,254,81,92,65,83,108,90
율곡로10길,327,183,144,21,33,38,64,57,114
율곡로17길,720,359,361,74,184,109,88,132,133
율곡로19길,1243,618,625,121,245,153,179,251,294
율곡로1길,206,101,105,25,21,28,37,36,59
율곡로3길,98,44,54,13,8,14,11,13,39
율곡로6길,499,280,219,54,51,85,115,81,113
은천로25길,744,390,354,129,88,125,112,117,173
은천로5길,1397,700,697,203,230,278,207,198,281
은천로6길,2566,1261,1305,230,513,456,382,338,647
은천로9길,873,440,433,110,120,138,139,133,233
은평로10길,2752,1339,1413,443,351,394,500,410,654
은평로11길,2127,1024,1103,330,261,338,393,332,473
은평로12길,2090,1037,1053,303,265,314,358,337,513
은평로13길,2439,1146,1293,384,276,395,424,377,583
은평로20길,1658,807,851,226,203,232,274,277,446
은평로21길,2726,1334,1392,432,332,417,464,454,627
은평로3길,1398,638,760,233,154,257,242,187,325
은평로6길,1712,829,883,278,250,385,302,229,268
은평로8길,2649,1279,1370,475,371,526,476,351,450
은평로9길,1198,528,670,166,245,267,212,126,182
을지로22길,16,9,7,1,1,1,2,2,9
을지로30길,127,75,52,9,9,19,15,27,48
을지로32길,109,65,44,6,11,15,17,22,38
응암로11길,9019,4384,4635,1129,1254,1458,1422,1511,2245
응암로12길,1802,890,912,226,215,224,280,314,543
응암로13길,1029,517,512,95,159,199,162,156,258
응암로14길,2145,1039,1106,283,281,333,347,350,551
응암로1길,1383,673,710,164,130,204,234,229,422
응암로20길,1753,860,893,227,213,197,279,315,522
응암로22길,1785,886,899,238,214,235,277,306,515
응암로29길,5244,2537,2707,836,684,894,932,753,1145
응암로34길,3452,1638,1814,646,418,530,619,479,760
응암로9길,1573,762,811,175,228,222,233,290,425
이문로12길,768,370,398,116,155,102,126,100,169
이문로24길,220,107,113,17,50,28,42,23,60
이문로25길,642,320,322,91,133,87,90,83,158
이문로28길,658,330,328,61,157,100,91,92,157
이문로42길,2721,1387,1334,331,456,395,396,458,685
이촌로14길,765,358,407,86,74,89,135,133,248
이촌로22길,1416,656,760,121,137,181,227,255,495
이태원로17길,337,159,178,36,44,67,67,50,73
이태원로20가길,759,388,371,53,128,170,83,125,200
이태원로20길,801,410,391,57,128,182,93,142,199
이태원로26길,611,291,320,47,113,110,78,108,155
이태원로27길,392,198,194,42,64,64,60,48,114
이태원로36길,933,441,492,96,141,195,184,114,203
이태원로42길,1375,593,782,54,81,165,224,289,562
이화장길,1149,528,621,116,212,216,167,145,293
인수봉로55길,3027,1444,1583,455,408,489,471,500,704
인수봉로56길,2541,1205,1336,385,344,320,433,437,622
인수봉로67길,554,269,285,75,75,88,81,99,136
인수봉로68길,1823,901,922,247,231,212,288,324,521
인수봉로77길,862,444,418,122,100,107,146,153,234
인수봉로78길,2825,1362,1463,452,390,418,442,470,653
인수봉로79길,2782,1377,1405,401,325,354,460,466,776
인촌로17가길,781,389,392,86,239,110,115,94,137
인촌로1길,878,413,465,77,207,155,129,118,192
인촌로24가길,256,142,114,21,70,47,23,28,67
인촌로24길,442,249,193,42,140,73,39,53,95
인촌로27길,1187,624,563,141,546,154,90,91,165
인촌로28길,118,66,52,12,38,10,17,19,22
인촌로7다길,6140,2830,3310,578,1716,1059,843,777,1167
인헌3길,1873,910,963,189,401,391,259,250,383
인헌4길,402,206,196,31,78,96,56,51,90
인헌6길,2517,1218,1299,246,613,535,339,302,482
인헌길,6649,3246,3403,935,1122,1298,1056,929,1309
일원로9길,3406,1691,1715,517,583,541,527,555,683
자동차시장1길,592,315,277,55,144,162,84,64,83
자양로15길,5326,2590,2736,687,828,936,880,915,1080
자양번영로1길,1684,851,833,241,266,245,280,280,372
자하문로10길,261,124,137,30,36,43,41,42,69
자하문로24길,662,311,351,116,93,89,116,121,127
자하문로41길,514,257,257,60,72,56,56,96,174
자하문로5길,698,324,374,102,70,122,128,94,182
자하문로7길,795,366,429,109,108,98,131,118,231
자하문로9길,631,289,342,84,83,86,99,99,180
잔다리로7안길,2357,1034,1323,244,419,555,385,284,470
잠원로14길,1150,541,609,308,124,173,272,131,142
장군봉1길,1006,494,512,129,158,172,130,158,259
장군봉2길,931,447,484,85,206,191,107,125,217
장문로45길,3474,1719,1755,434,515,528,574,595,828
장문로6길,620,294,326,137,87,79,155,88,74
장월로1길,2567,1167,1400,315,598,357,359,371,567
장월로1마길,664,279,385,100,161,82,98,79,144
장월로3길,440,224,216,79,51,58,78,61,113
장위로38길,1633,804,829,238,202,211,244,299,439
장위로40길,1673,849,824,223,227,203,271,315,434
장충단로8길,2453,1198,1255,303,420,360,394,394,582
장터2길,1409,700,709,153,174,214,244,239,385
장터3길,2930,1414,1516,371,402,487,489,471,710
장터5길,1291,614,677,131,182,205,210,204,359
장터길,1662,821,841,163,222,254,286,280,457
장한로18길,1357,670,687,182,187,272,196,206,314
장한로25길,329,156,173,40,52,52,54,68,63
장한로32길,1860,970,890,322,237,294,315,308,384
장한로5길,1141,569,572,169,165,201,168,204,234
전농로16길,1295,654,641,135,152,161,179,275,393
전농로17길,1326,676,650,148,209,152,208,243,366
전농로20길,1611,796,815,210,205,214,257,276,449
전농로27길,6818,3394,3424,882,1031,850,1063,1223,1769
전농로29길,3583,1820,1763,479,534,435,569,632,934
전농로37길,2208,1130,1078,239,357,285,319,373,635
전농로3길,1308,656,652,179,181,166,219,218,345
정릉로10길,1247,633,614,195,252,267,162,146,225
정릉로26길,939,454,485,92,84,125,157,163,318
정릉로27길,3735,1875,1860,600,497,504,616,582,936
정릉로31길,221,114,107,36,18,30,35,44,58
정릉로31나길,444,216,228,60,57,56,77,81,113
정릉로6길,43,20,23,0,11,3,6,9,14
제기로20길,1684,862,822,163,215,235,204,302,565
제기로2길,685,358,327,65,141,109,96,89,185
제기로38길,1225,631,594,137,145,201,185,218,339
제기로5길,956,521,435,72,159,169,145,138,273
조원로12길,3194,1632,1562,377,521,548,478,574,696
조원로13길,1819,889,930,248,343,359,279,247,343
조원로18길,1113,554,559,97,340,278,135,96,167
조원로31길,7253,3648,3605,932,1445,1325,1111,1067,1373
조원로6길,1604,804,800,143,297,302,227,245,390
조원중앙로2길,3425,1781,1644,400,580,600,507,608,730
종로24길,50,37,13,3,1,6,8,9,23
종로26길,27,22,5,1,0,2,6,7,11
종로41길,137,70,67,8,27,20,12,28,42
종로44길,366,245,121,9,20,40,41,97,159
종로51가길,540,266,274,62,70,82,85,112,129
종로57길,397,215,182,42,57,53,64,82,99
종로58가길,648,327,321,26,169,160,85,77,131
종로5길,1,1,0,0,0,0,0,1,0
종로63길,1299,689,610,109,194,157,202,282,355
종로65길,5225,2630,2595,517,708,702,852,1072,1374
종암로14길,2576,1270,1306,375,477,362,377,486,499
종암로19길,1402,713,689,189,203,201,231,234,344
종암로27길,2539,1292,1247,421,387,380,408,402,541
종암로5길,1291,706,585,136,391,204,140,134,286
주흥13길,944,438,506,95,155,266,169,93,166
주흥길,6404,3043,3361,460,1310,1774,1087,762,1011
중계로18길,225,107,118,68,35,7,57,40,18
중대로9길,3687,1919,1768,472,557,572,636,723,727
중랑역로13길,1027,547,480,83,142,173,142,224,263
중랑천로10길,3485,1755,1730,380,527,717,572,572,717
중랑천로12길,1717,853,864,182,293,422,255,260,305
중림로5길,223,120,103,14,26,15,26,30,112
중앙1길,4705,2273,2432,473,1101,908,603,618,1002
중앙길,2691,1331,1360,325,570,459,406,326,605
중앙로1길,640,334,306,89,93,100,89,116,153
중앙로34길,943,476,467,126,111,96,164,167,279
중앙로45길,2029,989,1040,317,274,283,355,354,446
중앙로46길,3481,1720,1761,500,490,578,546,551,816
중앙로6길,641,336,305,76,130,142,86,88,119
증가로10길,3499,1720,1779,386,637,473,547,555,901
증가로12나길,2754,1358,1396,416,515,416,457,424,526
증가로20길,3587,1764,1823,632,586,469,656,563,681
증가로24바길,1167,566,601,202,178,179,213,184,211
증가로25길,467,227,240,43,69,73,70,90,122
증가로29길,2297,1122,1175,294,273,363,406,370,591
증가로8길,3014,1433,1581,411,513,464,475,501,650
증산로15길,3265,1577,1688,544,388,447,543,507,836
증산로17길,2646,1306,1340,371,371,426,424,379,675
증산로23길,2281,1107,1174,261,385,442,345,376,472
증산로3길,1241,671,570,244,162,180,226,184,245
증산로9길,5476,2694,2782,772,680,785,886,898,1455
증산서길,4419,2227,2192,662,596,594,709,781,1077
지봉로17길,289,139,150,46,35,46,40,43,79
지양로3길,194,96,98,37,23,24,33,31,46
진흥로12길,1353,621,732,188,161,231,220,209,344
진흥로1길,6587,3153,3434,1036,942,1132,1128,1016,1333
진흥로7길,4324,2069,2255,685,573,784,685,654,943
창경궁로13길,50,36,14,0,3,1,9,17,20
창경궁로1길,64,42,22,4,6,5,7,15,27
창경궁로27길,922,446,476,83,285,169,112,101,172
창경궁로35길,929,439,490,123,202,143,124,134,203
창경궁로43길,1758,798,960,189,356,324,318,238,333
창덕궁1길,1360,633,727,199,171,185,246,192,367
창덕궁길,1513,714,799,214,178,223,265,248,385
창신3길,88,47,41,8,13,9,11,22,25
창신6길,837,435,402,65,95,80,149,163,285
창신길,3541,1799,1742,427,496,413,575,713,917
창의문로11길,280,144,136,44,34,28,50,50,74
천장산로4길,2223,1157,1066,236,497,344,303,352,491
천장산로7길,1020,523,497,89,514,126,83,76,132
천장산로9길,435,247,188,33,201,64,28,52,57
천중로40길,1298,648,650,178,155,239,197,235,294
천중로50길,4011,1984,2027,572,570,720,631,671,847
천호대로111길,2219,1077,1142,271,396,468,341,338,405
천호대로134길,1550,773,777,256,214,270,258,246,306
천호대로13길,672,354,318,74,110,119,121,101,147
천호대로16길,1290,668,622,196,183,209,211,213,278
천호대로170길,2558,1287,1271,354,384,552,388,386,494
천호대로17길,783,397,386,87,119,130,125,131,191
천호대로27길,328,198,130,11,56,33,45,62,121
천호대로77나길,456,232,224,45,71,60,70,109,101
천호옛14길,676,341,335,77,102,118,90,112,177
청계천로10나길,1424,729,695,196,230,187,221,247,343
청계천로12가길,1055,548,507,127,186,136,168,194,244
청구로17길,1892,930,962,275,295,324,313,299,386
청구로21길,2430,1191,1239,333,407,405,390,403,492
청구로3길,4254,2111,2143,485,699,660,678,728,1004
청두곶길,3874,1845,2029,608,574,666,633,552,841
청룡3길,2620,1261,1359,118,1141,666,226,207,262
청룡4길,1780,866,914,173,310,299,254,277,467
청룡7길,3832,1811,2021,180,1636,959,353,294,410
청룡8길,3646,1783,1863,385,749,697,511,497,807
청룡길,3538,1769,1769,277,909,726,459,451,716
청룡중앙길,2433,1198,1235,262,546,423,335,347,520
청림2길,1048,537,511,124,147,194,149,140,294
청림5길,4677,2366,2311,742,651,654,764,752,1114
청림길,758,387,371,83,114,119,105,125,212
청파로43길,1355,589,766,113,362,262,174,159,285
청파로45길,408,183,225,36,109,84,48,56,75
청파로47길,1011,393,618,100,322,173,125,111,180
청파로49길,504,215,289,49,135,92,73,47,108
청파로85길,1539,796,743,171,230,254,241,305,338
청파로93길,473,250,223,47,73,83,75,77,118
청황길,43,26,17,4,4,5,11,12,7
초록마을로8길,8273,4014,4259,1575,1102,1633,1416,1118,1429
충정로4길,720,351,369,89,107,136,117,102,169
충정로5길,106,62,44,8,22,15,17,18,26
충정로6길,300,164,136,22,59,56,31,41,91
충정로9길,281,130,151,21,85,89,34,24,28
탑골로2길,1403,684,719,238,183,199,241,222,320
탑골로4길,1014,523,491,164,123,109,182,151,285
토정로11길,514,249,265,53,107,148,73,55,78
토정로31길,199,96,103,19,29,33,32,37,49
토정로37길,44,24,20,5,9,7,8,12,3
통일로12길,1814,847,967,259,268,233,344,253,457
통일로14길,421,196,225,39,30,40,48,69,195
통일로25길,655,319,336,95,94,83,100,120,163
통일로37길,990,446,544,81,112,110,154,200,333
통일로39가길,818,387,431,85,129,92,113,165,234
통일로40길,289,143,146,31,37,29,46,51,95
통일로63길,1582,737,845,179,223,256,237,267,420
통일로66길,322,154,168,28,64,85,41,46,58
통일로67길,1043,458,585,100,224,265,154,111,189
통일로68길,1554,762,792,183,217,212,246,255,441
통일로69길,2277,1079,1198,310,304,350,364,377,572
통일로71길,1665,796,869,242,230,250,284,282,377
통일로73길,1965,906,1059,266,300,293,299,324,483
통일로77길,1456,678,778,163,317,294,199,196,287
통일로78길,3218,1570,1648,412,454,510,524,523,795
통일로83길,1678,808,870,207,265,320,247,262,377
통일로85길,1492,726,766,178,261,285,213,225,330
통일로87길,1429,682,747,179,235,242,248,210,315
통일로92길,9877,4877,5000,1284,1367,1394,1572,1724,2536
퇴계로10길,294,149,145,38,26,51,37,37,105
퇴계로20길,52,26,26,5,7,7,5,8,20
퇴계로28길,80,48,32,8,8,8,13,13,30
퇴계로32길,171,79,92,14,20,16,30,32,59
퇴계로46길,102,56,46,8,16,20,11,18,29
퇴계로4길,1510,792,718,98,116,166,196,245,689
퇴계로53길,385,202,183,7,14,37,50,89,188
퇴계로56길,959,494,465,94,134,129,147,160,295
퇴계로74길,244,134,110,18,22,22,44,56,82
퇴계로76길,1311,719,592,89,201,162,204,282,373
퇴계로83길,880,488,392,79,102,120,116,139,324
퇴계로87길,3417,1757,1660,306,530,588,500,580,913
퇴계로88길,1510,777,733,172,227,186,248,290,387
퇴계로8길,2636,1336,1300,220,243,311,398,422,1042
퇴계로90길,2964,1468,1496,366,469,409,518,539,663
팔판길,354,164,190,45,43,47,43,64,112
평창11길,2409,1133,1276,371,380,286,383,426,563
평창길,3485,1689,1796,510,468,426,548,611,922
포방터길,2092,1020,1072,252,293,248,313,382,604
풍성로25길,857,438,419,99,117,132,114,179,216
풍성로37가길,2545,1297,1248,302,355,438,427,485,538
풍성로54길,1904,937,967,303,282,310,295,333,381
필운대로1길,703,334,369,125,87,83,148,104,156
필운대로5가길,844,385,459,142,107,137,153,125,180
필운대로6길,715,361,354,108,89,88,125,103,202
필운대로7길,904,401,503,161,103,148,160,131,201
학동로20길,2013,937,1076,139,317,472,442,292,351
한강대로104마길,968,573,395,80,128,116,160,209,275
한강대로10길,271,138,133,37,43,42,30,50,69
한강대로15길,445,237,208,34,48,76,71,74,142
한강대로21길,162,94,68,16,18,29,23,27,49
한강대로23길,6,4,2,1,0,2,1,0,2
한강대로38길,176,79,97,4,6,15,19,50,82
한강대로40길,115,60,55,2,15,31,14,15,38
한강대로43길,864,422,442,67,118,252,136,118,173
한강대로52길,434,222,212,34,60,98,67,72,103
한강대로62가길,57,33,24,4,5,3,8,11,26
한강대로62길,898,450,448,71,153,166,128,158,222
한강대로62다길,435,225,210,48,61,101,66,69,90
한강대로7길,1096,567,529,127,94,155,165,190,365
한강대로88길,107,79,28,2,11,9,20,29,36
한강대로96길,2904,1528,1376,279,400,435,469,487,834
한글비석로1길,403,203,200,99,57,39,79,63,66
한글비석로20길,385,215,170,41,69,47,69,64,95
한글비석로23길,3249,1575,1674,479,471,408,504,565,822
한글비석로46길,5642,2851,2791,775,772,680,920,970,1525
한글비석로48길,699,314,385,114,91,95,134,119,146
한남대로20길,215,102,113,19,40,45,39,25,47
한남대로21길,54,29,25,10,8,14,11,7,4
한남대로27길,771,351,420,74,116,228,130,88,135
한남대로42길,502,231,271,64,70,93,92,77,106
한림말1길,746,353,393,101,111,152,109,92,181
한림말3길,628,290,338,86,92,120,98,75,157
한림말길,1004,451,553,158,137,219,186,137,167
한천로101가길,1021,531,490,181,123,99,187,175,256
한천로11길,3002,1524,1478,361,345,378,492,535,891
한천로130길,5246,2602,2644,660,760,821,808,887,1310
한천로131길,2547,1264,1283,257,468,446,387,365,624
한천로132길,4084,2047,2037,561,617,600,716,672,918
한천로143길,1529,701,828,123,269,243,217,230,447
한천로144길,3625,1764,1861,397,615,587,571,626,829
한천로14길,3179,1616,1563,418,440,489,503,601,728
한천로150길,4120,2050,2070,407,682,641,643,700,1047
한천로155길,1743,872,871,250,216,237,292,292,456
한천로170길,4937,2409,2528,738,704,670,807,835,1183
한천로17길,776,399,377,106,111,89,121,135,214
한천로18길,2003,1034,969,223,211,309,315,394,551
한천로24길,4627,2356,2271,587,647,885,796,799,913
한천로33길,579,286,293,87,79,74,109,106,124
한천로36길,2430,1250,1180,312,328,299,386,445,660
한천로46길,1975,1013,962,299,282,302,309,357,426
한천로78길,1108,546,562,109,191,162,169,203,274
한천로80길,1502,741,761,173,268,213,211,283,354
해등로16길,1907,916,991,305,336,270,280,368,348
해등로26길,538,265,273,93,84,65,79,126,91
행당로17길,927,450,477,105,167,147,112,176,220
행당로1길,1212,604,608,179,178,176,169,225,285
행당로8길,428,197,231,66,56,54,80,79,93
행운1길,3075,1526,1549,284,694,625,405,414,653
행운길,7484,3712,3772,615,2046,1876,890,799,1258
혜화로14길,791,371,420,145,143,130,137,108,128
혜화로3길,1370,644,726,201,361,204,172,200,232
호암로18길,1168,611,557,163,162,198,187,211,247
호암로22길,1785,1080,705,86,629,434,250,166,220
호암로26길,6855,4409,2446,382,1948,1544,1176,798,1007
홍릉로29길,289,153,136,30,53,45,43,42,76
홍릉로5길,663,331,332,65,88,70,71,127,242
홍연길,915,476,439,124,114,117,158,147,255
홍은중앙로8길,257,117,140,30,40,30,38,50,69
홍은중앙로9길,2416,1197,1219,268,276,266,386,442,778
홍제내2나길,778,364,414,130,80,109,139,121,199
홍제내길,1422,663,759,198,183,218,229,214,380
홍제천로2길,2603,1328,1275,280,372,370,374,491,716
홍지문2길,759,378,381,93,151,94,106,129,186
홍지문길,2571,1255,1316,413,450,300,419,471,518
화계사길,732,375,357,102,105,100,114,129,182
화곡로15길,5681,2724,2957,914,860,916,971,891,1129
화곡로20길,3332,1597,1735,530,459,687,508,464,684
화곡로25길,1129,562,567,90,161,208,176,196,298
화곡로31길,2536,1223,1313,276,404,471,353,427,605
화곡로42길,1501,783,718,105,295,402,252,194,253
화랑로11길,612,242,370,55,194,93,75,75,120
화랑로18나길,266,139,127,40,39,39,41,39,68
화랑로19길,1855,935,920,248,245,227,296,342,497
화랑로25길,222,113,109,25,27,29,31,30,80
화랑로32길,4529,2215,2314,550,778,580,744,736,1141
화랑로40길,2562,1316,1246,309,376,377,437,486,577
화랑로43길,724,379,345,89,83,95,97,120,240
화랑로45길,590,279,311,79,81,90,92,87,161
화랑로47길,564,280,284,87,85,78,101,79,134
화랑로51길,725,307,418,166,164,75,116,126,78
화랑로53길,37,15,22,6,6,6,7,1,11
화랑로5길,1043,509,534,159,161,126,182,148,267
환일길,3181,1507,1674,317,549,402,435,633,845
황물로15길,723,391,332,61,109,87,129,136,201
황물로3길,3351,1639,1712,291,587,530,542,587,814
회기로21길,364,181,183,35,90,61,46,43,89
회기로23길,646,315,331,66,232,94,64,78,112
회기로28길,535,280,255,27,201,149,44,38,76
회기로29길,2093,1021,1072,161,767,434,215,185,331
회나무로13길,2103,927,1176,182,244,336,335,334,672
회나무로13나길,1855,809,1046,139,207,323,288,309,589
회나무로44길,743,353,390,112,86,123,147,107,168
효령로29길,2341,1096,1245,374,314,448,415,332,458
효령로34길,1180,571,609,179,159,207,187,181,267
효령로40길,641,318,323,124,79,100,120,99,119
효령로67길,2720,1293,1427,503,379,518,452,350,518
효령로68길,742,377,365,167,90,136,140,98,111
효령로74길,989,480,509,154,159,191,179,141,165
효창원로39길,2169,1018,1151,321,288,373,363,305,519
효창원로62길,234,105,129,49,37,28,51,29,40
효창원로8길,590,299,291,106,87,79,112,85,121
효창원로93길,1743,821,922,215,309,252,275,271,421
효창원로98길,4650,2299,2351,629,868,747,769,722,915
후암로23길,559,271,288,75,71,79,89,90,155
후암로30길,1633,808,825,230,215,306,291,235,356
후암로35길,810,396,414,103,120,107,112,150,218
후암로4길,2805,1368,1437,487,411,497,436,406,568
휘경로23길,917,456,461,101,120,120,150,166,260
휘경로2길,1215,604,611,121,304,196,169,160,265
휘경로3길,2640,1296,1344,273,508,414,413,430,602
희우정로16길,3799,1792,2007,521,616,768,593,535,766
